a.m.	[ˌeɪ ˈem] abbr. 上午，午前; 
abandon	[əˈbændən] vt. 放弃，抛弃;离弃，丢弃 n. 放任，放纵;完全屈从于压制 
abdomen	[ˈæbdəmən] n. 腹部 
abide	[əˈbaɪd] vt. 遵守;容忍，忍受 vi. 持续;经受住，顶住 
ability	[əˈbɪləti, əˈbɪlɪti] n. 能力，资格 
able	[ˈebəl, ˈeɪbl] adj. 能够的 
abolish	[əˈbɒlɪʃ, əˈbɑ:lɪʃ] vt. 消灭 
about	[əˈbaʊt] prep. 关于 adv. 大约 adj. 在附近的 
above	[əˈbʌv] prep. （表示程度）超过 adv. 以上 n. 上述 adj. 上述的 
abroad	[əˈbrɔ:d, əˈbrɔd] adv. 到国外，在海外 adj. 往国外的 n. 海外，异国 
abrupt	[əˈbrʌpt] adj. 陡峭的 
absence	[ˈæbsəns] n. 缺席，缺勤 
absent	[ˈæbsənt] adj. 缺席的，不在场的 
absolute	[ˈæbsəlu:t, ˈæbsəˌlut] adj. 绝对的，完全的;不受任何限制[约束]的 n. 绝对;绝对事物 
absorb	[əbˈsɔ:rb, əbˈsɔ:b] vt. 吸收（液体、气体等） 
abstract	[ˈæbˌstrækt, ˈæbstrækt] adj. 抽象的，理论上的 n. 摘要 vt. 提取，分离 
absurd	[əbˈsɜ:d, əbˈsɜ:rd] adj. 荒谬的;荒唐的 n. 无价值，无意义 
abundant	[əˈbʌndənt] adj. 大量的，充足的 
abuse	[əˈbjuz, əˈbju:s] n. 滥用;恶习 vt. 滥用;虐待 
academic	[ˌækəˈdɛmɪk, ˌækəˈdemɪk] adj. 学院的，大学的，学会的，（学术，文艺）协会的;学究的，学理上的，空谈的，非实用的 n. 学者;大学教师，大学生，学会会员 
accelerate	[ækˈsɛləˌret, əkˈseləreɪt] vt. 促进;（使）加快，（使）增速 vi. 加快，加速 
accent	[ˈæksent, ˈækˌsɛnt] n. 口音 
accept	[ækˈsɛpt, əkˈsept] vi. 承认;同意 vt. 接受;承认 
access	[ˈæksɛs, ˈækses] n. 入口，出口;接近，进入 vt. 接近，进入;使用，接近，获取 
accident	[ˈæksɪdənt, ˈæksɪdənt, -ˌdɛnt] n. 事故 
accidental	[ˌæksɪˈdɛntl, ˌæksɪˈdentl] adj. 意外的，偶然（发生）的;附属的 n. 偶然;次要方面 
accommodate	[əˈkɒmədeɪt, əˈkɑ:mədeɪt] vt. 容纳;使适应 vi. [后面省去反身代词]适应于;（眼）作调节，调节眼球的晶状体（使其变得适应不同距离的物体） 
accommodations	[əkɒmə'deɪʃnz] n. 住宿 
accompany	[əˈkʌmpəni, əˈkʌmpəni, əˈkʌmpni] vt. 陪伴，陪同;附加，补充 vi. 伴奏 
accomplish	[əˈkʌmplɪʃ, əˈkɑ:mplɪʃ] vt. 完成 
according to	[əˈkɔ:dɪŋ tə, əˈkɔ:rdɪŋ tə] na. 根据，按照 
account	[əˈkaʊnt] n. 账，账目 vi. 解释 vt. 认为 
accumulate	[əˈkju:mjəleɪt, əˈkjumjəˌlet] vt.&vi. 堆积，积累 vi. （数量）逐渐增加，（质量）渐渐提高 
accurate	[ˈækjərət, ˈækjərɪt] adj. 精确的，准确的 
accuse	[əˈkju:z, əˈkjuz] v. 指控 
accustom	[əˈkʌstəm] vt. 使习惯 
ache	[ek, eɪk] n. 疼痛 vi. 疼痛;渴望 
achieve	[əˈtʃi:v, əˈtʃiv] vt. 实现;取得 vi. 达到预期的目的，实现预期的结果，如愿以偿 
acid	[ˈæsɪd] adj. 酸的;酸性的 n. <化>酸;酸味物质 
acquaint	[əˈkweɪnt, əˈkwent] vt. 使熟悉 
acquaintance	[əˈkweɪntəns, əˈkwentəns] n. 相识 
acquire	[əˈkwaɪə(r), əˈkwaɪr] vt. 学到 
acre	[ˈekɚ, ˈeɪkə(r)] n. 英亩 
acrobat	[ˈækrəbæt, ˈækrəˌbæt] n. 杂技演员 
across	[əˈkrɔ:s, əˈkrɒs] prep. 穿过;横穿，横过 adv. 横过，越过;在对面 
act	[ækt] v. 行动;表演 n. 行为;行动 
action	[ˈækʃən, ˈækʃn] n. 行动，活动 
active	[ˈæktɪv] adj. 积极的，活跃的，有生气的;迅速的，敏捷的 n. [语法]主动语态;积极分子，活跃的人 
activity	[ækˈtɪvɪti, ækˈtɪvəti] n. 活动 
actor	[ˈæktə(r), ˈæktɚ] n. 行动者 
actress	[ˈæktrəs, ˈæktrɪs] n. 女演员 
actual	[ˈæktʃuəl] adj. 实际的 
ad	[æd] n. 广告 
ad.	[] abbr. 副词 
adapt	[əˈdæpt] vi. 适应于，适应不同情况（或环境）(to) vt. 改编，改写;改变…以适合(for) 
add	[æd] vt. 增加 vi. 增加 n. 加法，加法运算 
addition	[əˈdɪʃn, əˈdɪʃən] n. 加，增加，附加 
additional	[əˈdɪʃənl, ə'dɪʃənl] adj. 补充 
address	[ˈædres, əˈdres] n. 地址;称呼 v. 称呼;演说 
adequate	[ˈædɪkwɪt, ˈædɪkwət] adj. 足够的 
adhere	[ədˈhɪə(r), ədˈhɪr] vi. 坚持;附着 vt. 使粘附;遵循，坚持 
adjective	[ˈædʒɪktɪv] n. 形容词 adj. 形容词的;附属的，不独立的 
adjust	[əˈdʒʌst] vt.&vi. （改变…以）适应，调整，校正 
administration	[ ædˌmɪnɪˈstreʃən, ədˌmɪnɪˈstreɪʃn] n. 管理 
admire	[ædˈmaɪr, ədˈmaɪə(r)] vt. 欣赏 
admit	[ædˈmɪt, ədˈmɪt] vt.&vi. 许可进入 vt. 允许 vi. 承认 
adopt	[əˈdɒpt, əˈdɑ:pt] vt. 收养 
adult	[ˈædʌlt,  əˈdʌlt, ˈædʌlt] adj. 成年的;成年人的 n. 成年的人或动物 
advance	[ədˈvɑ:ns, ədˈvæns] vt. 预付 vi. （数量等）增加 n. 增长 adj. 预先的 
advanced	[ədˈvɑ:nst, ədˈvænst] adj. 先进的;高等的，高深的 v. 前进(advance的过去式和过去分词);增加 
advantage	[ədˈvæntɪdʒ, ədˈvɑ:ntɪdʒ] n. 有利条件 vt. 有利于 vi. 得益，获利 
adventure	[ədˈventʃə(r), ædˈvɛntʃɚ] n. 奇遇 
advertise	[ˈædvərtaɪz, ˈædvətaɪz] vt. 宣扬;做广告，做宣传 vi. 登广告，做广告;做宣传 
advice	[əd'vaɪs, ədˈvaɪs] n. 建议 
advise	[ədˈvaɪz, ædˈvaɪz] vt. （商业）通知，报告;提议，建议 vi. 接受劝告，商量;建议，提供意见 
adviser	[ədˈvaɪzə(r), ædˈvaɪzɚ] n. 顾问，劝告者 
affair	[əˈfeə(r), əˈfer] n. 事务 
affect	[əˈfɛkt, əˈfekt] vt. 影响;假装 n. 感情，情感，心情;[精神病学]（表露或觉察到的）情绪反应 
affection	[əˈfekʃn, əˈfɛkʃən] n. 喜爱，慈爱 
affirm	[əˈfɜ:rm, əˈfɜ:m] vt.&vi. 断言，肯定 
affirmative	[əˈfɜ:mətɪv, əˈfɜ:rmətɪv] adj. 肯定的;赞成的，同意的 n. 肯定词，肯定语;正方 
afford	[əˈfɔ:d, əˈfɔ:rd] vt. 提供 
afraid	[əˈfred, əˈfreɪd] adj. 恐怕 
Africa	['æfrɪkə, ˈæfrɪkə] n. 非洲 adj. 非洲的 
African	[ˈæfrɪkən] adj. 非洲的;非洲人的 n. 非洲人，非洲居民;（非洲）黑人民 
after	[ˈɑ:ftə(r), ˈæftə(r)] prep. …后的 conj. 在…以后 adv. 以后，继后 adj. 后来的，以后的 
afternoon	[ˌæftərˈnu:n, ˌɑ:ftəˈnu:n] n. 下午 
afterward	['ɑ:ftəwəd, ˈæftəwəd] adv. <美>以后，过后 
again	[əˈgen, əˈɡɛn] adv. 再一次 
against	[əˈgenst, əˈɡenst] prep. 反对 
age	[eɪdʒ, edʒ] n. 年龄 vt.&vi. （使）长大 vi. [化学]老化 vt. [化学]使老化 
agency	[ˈeɪdʒənsi, ˈedʒənsi] n. 代理 
agent	[ˈeɪdʒənt, ˈedʒənt] n. 代理人 vt. 由…作中介 adj. 代理的 
ago	[əˈgoʊ, əˈgəʊ] adv. 以前 
agony	[ˈægəni, ˈæɡəni] n. 极大的痛苦 
agree	[əˈɡri, əˈgri:] vt.&vi. 同意，赞同 vi. [语]一致，符合 vt. 同意，承认 
agreement	[əˈɡrimənt, əˈgri:mənt] n. 协定，协议 
agricultural	[ˌæɡrɪ'kʌltʃərəl] adj. 农业的，耕种的 
agriculture	[ˈægrɪkʌltʃə(r), ˈæɡrɪˌkʌltʃɚ] n. 农业 
ahead	[əˈhɛd, əˈhed] adv. 向前 
aid	[eɪd, ed] n. 帮助 vt. 帮助 vi. 帮助 
aim	[em, eɪm] vt. 瞄准 vi. 旨在 n. 目的 
air	[er, eə(r)] n. 空运 vt.&vi. 晾晒 vt. 使房间通风， 透气 
aircraft	[ˈerkræft, ˈeəkrɑ:ft] n. 飞机，航空器， 
airline	[ˈerlaɪn, ˈeəlaɪn] n. 航空公司 
airmail	[ˈeəmeɪl, ˈermeɪl] n. 航空邮件 vt. 航空邮寄 adj. 航空邮件的 adv. 通过航空邮寄 
airplane	[ˈeəpleɪn, ˈerpleɪn] n. <美>飞机 
airport	[ˈeəpɔ:t, ˈerpɔ:rt] n. 机场 
alarm	[əˈlɑ:m, əˈlɑ:rm] n. 警报;闹铃 vt. 警告;使惊恐 
alcohol	[ˈælkəhɔ:l, ˈælkəhɒl] n. 乙醇，酒精 
alert	[əˈlɜ:rt, əˈlɜ:t] adj. 警觉的，警惕的，注意的 n. 警报 vt. 向…报警 
alike	[əˈlaɪk] adj. 同样的，相似的 adv. 同样地;两者都，同样地 
alive	[əˈlaɪv] adj. 活着的 
all	[ɔl, ɔ:l] adj. 全部的 pron. 全部 adv. 全部地 n. 全体 
allied	[ˈælaɪd, əˈlaɪd,ˈælˌaɪd] adj. 同盟的，同盟国的;联合的 v. 联合(ally的过去分词) 
allow	[əˈlaʊ] vt. 允许;承认 vi. 容许;考虑 
ally	[ˈælaɪ, 'ælaɪ] n. 联盟;同盟国，同盟者 vt.&vi. （使）联盟，（使）同盟;（使）结盟，（使）联姻 
almost	[ˈɔ:lməʊst, ˈɔ:lmoʊst] adv. 将近 
alone	[əˈləʊn, əˈloʊn] adj. 单独的;独一无二的 adv. 单独地;独自地 
along	[əˈlɒŋ, əˈlɔ:ŋ] adv. 一起;向前 prep. 沿着;顺着 
alongside	[əˌlɔ:ŋˈsaɪd, əˌlɒŋˈsaɪd] adv. 在…的侧面;在…旁边 prep. 在…旁边;横靠 
aloud	[əˈlaʊd] adv. 大声 
already	[ɔ:lˈredi, ɔlˈrɛdi] adv. 早已，已经 
also	[ˈɔ:lsoʊ, ˈɔ:lsəʊ] adv. 也;同样 conj. 另外 
alter	[ˈɔ:ltə(r), ˈɔltɚ] vt. 改变;更改 vi. 改变;修改 
alternate	[ˈɔ:ltərnət, ɔ:lˈtɜ:nət] adj. 交替的 vi. 交替 vt. 使交替 n. 〈美〉（委员）代理人 
although	[ɔlˈðo, ɔ:lˈðəu] conj. 虽然 
altogether	[ˌɔ:ltəˈgeðə(r), ˌɔltəˈɡɛðɚ] adv. 总共;全部地 n. 〈口〉裸体 
always	[ˈɔ:lweɪz, ˈɔlwez,-wɪz,-wiz] adv. 常常 
AM	[, ˌeɪ ˈem] abbr. amplitude modulation 调幅 
am	[əm, æm] abbr. (=amplitude modulation) <无>调频，调谐 vi. （用于第一人称单数现在时）是 aux. （与v-ing连用构成现在进行时，与v-ed连用构成被动语态） 
amaze	[əˈmez, əˈmeɪz] vt. 使大为吃惊，使惊奇 n. 吃惊，好奇 
ambassador	[æmˈbæsədə(r), æmˈbæsədɚ, -ˌdɔr] n. 大使，使节 
ambiguous	[æmˈbɪɡjuəs, æmˈbɪgjuəs] adj. 模棱两可 
ambition	[æmˈbɪʃn, æmˈbɪʃən] n. 抱负;渴望得到的东西 vt. 追求;有…野心 
ambitious	[æmˈbɪʃəs] adj. 有雄心的 
ambulance	[ˈæmbjələns] n. 救护车 
America	[ə'merɪkə, əˈmɛrɪkə] n. 美洲 
American	[əˈmerɪkən, əˈmɛrɪkən] n. 美国人，美洲人;美国英语 adj. 美国的，美洲的;地道美国式的 
among	[əˈmʌŋ] prep. （表示牵涉）经过 
amount	[əˈmaʊnt] n. 量，数量;总额 vi. （在意义、价值、效果、程度等方面）等于;等同，接近 
ample	[ˈæmpl, ˈæmpəl] adj. 足够的 
amuse	[əˈmju:z, əˈmjuz] vt. 娱乐 
amusement	[əˈmju:zmənt, əˈmjuzmənt] n. 娱乐 
analysis	[əˈnælɪsɪs, əˈnæləsɪs] n. 分析，分解 
analyze	[ˈænəˌlaɪz, 'ænəlaɪz] vt. <美>分析 
ancient	[ˈenʃənt, ˈeɪnʃənt] adj. 古代的，已往的;古老的，过时的 n. 古代人;古文明国的国民 
and	[ənd, ən,ænd, ənd] conj. 而且 
angel	[ˈendʒəl, ˈeɪndʒl] n. 安琪儿 
anger	[ˈæŋɡɚ, ˈæŋgə(r)] n. 愤怒 vt.&vi. 激怒 vi. 发怒 
angle	[ˈæŋgl, ˈæŋɡəl] n. 角 vt. 使形成（或弯成）角度 vi. 垂钓 
angry	[ˈæŋɡri, ˈæŋgri] adj. 生气的 
animal	[ˈænɪml, ˈænəməl] n. 动物，兽，牲畜;<俚>家畜，牲口 adj. 动物的;肉体的 
anniversary	[ˌænɪˈvɜ:səri, ˌænɪˈvɜ:rsəri] n. 周年纪念日 adj. 周年的;周年纪念的 
announce	[əˈnaʊns] vi. 宣布参加竞选;当播音员 vt. 宣布;述说 
annoy	[əˈnɔɪ] vt. 打扰 vi. 惹恼，令人讨厌，打搅 n. 烦恼（等于annoyance） 
annual	[ˈænjuəl] adj. 每年的;一年的 n. 年刊;一年生植物 
another	[əˈnʌðɚ, əˈnʌðə(r)] adj. 又一个;再一个 pron. 另一个，别个;再一个 
answer	[ˈænsə(r), ˈɑ:nsə(r)] vt.&vi. 答复; 解答 n. 回答;答案 
ant	[ænt] n. 蚂蚁 
anxiety	[æŋˈzaɪɪti, æŋˈzaɪəti] n. 焦虑，忧虑 
anxious	[ˈæŋkʃəs] adj. 焦急的 
any	[ˈeni, ˈɛni] adj. 任何的 pron. 任何 adv. 稍微，少许 
anybody	[ˈenibɒdi, ˈenibʌdi] pron. 任何人，无论谁;随便哪一个人 n. <口语>重要的人，有声名的人;平常人 
anyhow	[ˈenihaʊ, ˈɛniˌhaʊ] adv. 无论如何 
anyone	[ˈeniwʌn, ˈɛniˌwʌn, -wən] pron. 任何人 
anything	[ˈɛniˌθɪŋ, ˈeniθɪŋ] pron. 任何东西 
anyway	[ˈeniweɪ, ˈɛniˌwe] adv. 无论如何 
anywhere	[ˈeniwer, ˈeniweə(r)] adv. 任何地方 
apartment	[əˈpɑ:tmənt, əˈpɑ:rtmənt] n. 房间 
apologize	[əˈpɑ:lədʒaɪz, əˈpɒlədʒaɪz] vi. 道歉，认错 
apology	[əˈpɑ:lədʒi, əˈpɒlədʒi] n. 道歉认错，愧悔 
apparent	[əˈpærənt, əˈpærənt, əˈpɛr-] adj. 易看见的，可看见的 
appeal	[əˈpi:l, əˈpil] n. 上诉 vi. （迫切）要求 vt. 将…移交上级法院审理 
appear	[əˈpɪə(r), əˈpɪr] vi. 发表 
appearance	[əˈpɪərəns, əˈpɪrəns] n. 外貌，外观 
appendix	[əˈpɛndɪks, əˈpendɪks] n. 附录 
appetite	[ˈæpɪtaɪt, ˈæpɪˌtaɪt] n. 欲望 
applaud	[əˈplɔ:d, əˈplɔd] vt. 鼓掌欢迎，欢呼;称赞，赞许 vi. 夸赞，鼓掌 
apple	[ˈæpl, ˈæpəl] n. 苹果 
application	[ˌæplɪˈkeɪʃn, ˌæplɪˈkeʃən] n. 适用，应用，运用 
apply	[əˈplaɪ] vt. 申请;涂 vi. 申请，请求，适用;适用，适合 
appoint	[əˈpɔɪnt] vt. 任命，委派 
appointment	[əˈpɔɪntmənt] n. 任命 
appreciate	[əˈpriʃiˌet, əˈpri:ʃieɪt] vt. 欣赏;感激 vi. （使）增值，涨价 
approach	[əˈprəʊtʃ, əˈproʊtʃ] vt.&vi. 接近，走近，靠近 vt. 接近 n. 方法 vi. 靠近 
approval	[əˈpru:vl, əˈpruvəl] n. 批准 
approve	[əˈpruv, əˈpru:v] vt.&vi. 赞成，同意 vt. 批准 vi. 赞同 
April	[ˈeprəl, ˈeɪprəl] n. 四月 
apt	[æpt] adj. 恰当的，适当的;有…倾向的 abbr. (=automatically programmed tool)自动数控程序;(=automatic picture transmission)（人造卫星）自动图像传输 
Arabian	[əˈreɪbiən, əˈrebiən] adj. 阿拉伯的，阿拉伯人的 n. 阿拉伯人，阿拉伯半岛居民 
arch	[ɑ:rtʃ, ɑ:tʃ] n. 拱门 vt. （使）弯成拱形 vi. 拱起 adj. 主要的 
architect	[ˈɑ:rkɪtekt, ˈɑ:kɪtekt] n. 建筑师，设计师 
architecture	[ˈɑ:rkɪtektʃə(r), ˈɑ:kɪtektʃə(r)] n. 体系结构 
Arctic	[ˈɑ:ktɪk, ˈɑ:rktɪk] adj. 北极的;极冷的 n. 北极圈，北极地带 
are	[ɑ:(r), ɑ:r] vi. （用于第二人称单复数现在时，第一、三人称复数现在时）是 n. 公亩（等于100平方米） 
area	[ˈeriə, ˈeəriə] n. 地区 
argue	[ˈɑ:gju:, ˈɑ:rgju:] vt. 坚决主张;提出理由证明 vi. 争论，辩论;提出理由 
argument	[ˈɑ:gjumənt, ˈɑ:rgjumənt] n. 论据 
arise	[əˈraɪz] vi.&vt. 出现 
arm	[ɑ:m, ɑ:rm] n. 臂 vi. 准备（斗争），准备行动（against） vt. 装备（防御工事） 
army	[ˈɑ:mi, ˈɑ:rmi] n. 军队 
around	[əˈraʊnd] adv. 大约;旋转 prep. 围绕;在附近 
arouse	[əˈraʊz] vt. 引起 
arrange	[əˈreɪndʒ, əˈrendʒ] vt. 整理;把…（系统地）分类 vi. （就某事与某人）达成协议，（与某人）商定（某事）(with a person about 或 for a thing);[音乐]（尤指专业）改编乐曲 
arrest	[əˈrest, əˈrɛst] vt. 逮捕，拘捕 vi. 心跳停止 n. 拘留 
arrival	[əˈraɪvəl, əˈraɪvl] n. 到达，抵达 
arrive	[əˈraɪv] vi. 到达，来 
arrow	[ˈæroʊ, ˈærəʊ] n. 矢，箭 
art	[ɑ:rt, ɑ:t] n. 艺术 vi. thou art 即 you are
artificial	[ˌɑ:tɪˈfɪʃl, ˌɑ:rtɪˈfɪʃl] adj. 人工的;人造的 n. 人造肥料;<美>假花 
artist	[ˈɑ:tɪst, ˈɑ:rtɪst] n. 艺术家 
as	[æz,əz, əz] adv. 同样地，一样地 prep. 作为，以…的身份 conj. 由于 n. 阿斯（古罗马重量单位，约373克） 
ash	[æʃ] n. 灰，灰烬 
ashamed	[əˈʃeɪmd, əˈʃemd] adj. 惭愧的，羞耻的，害臊的 
ashore	[əˈʃɔr, əˈʃor, əˈʃɔ:(r)] adv. 上岸 
Asia	[ˈeɪʒə] n. 亚洲 
Asian	[ˈeɪʃn, ˈeʒən, ˈeʃən] n. 亚洲人 adj. 亚洲的，亚洲人的 
aside	[əˈsaɪd] adv. 在旁边，在一边，到旁边，到一边 n. [戏]旁白，独白 prep. 在…旁边 
ask	[æsk, ɑ:sk] vt.&vi. 问，询问 vt. 询问 vi. 要求 
asleep	[əˈslip, əˈsli:p] adj. 睡着的;休眠的 adv. 熟睡地;处于麻木不仁的状态 
aspect	[ˈæspɛkt, ˈæspekt] n. 方面 
assemble	[əˈsembl, əˈsɛmbəl] vt.&vi. 集合，收集 vt. 装配，组合 
assembly	[əˈsembli, əˈsɛmbli] n. 装配 
assert	[əˈsɜ:t, əˈsɜ:rt] vt. 声称，断言 
assignment	[əˈsaɪnmənt] n. 分给，分配 
assist	[əˈsɪst] n. 帮助 vt. 帮助 vi. 援助 
assistance	[əˈsɪstəns] n. 帮助，援助 
assistant	[əˈsɪstənt] n. 助手，助理;[化学]（染色的）助剂 adj. 助理的;辅助的 
associate	[əˈsəʊʃieɪt, əˈsoʊʃieɪt] vt. 联想;（使）发生联系 vi. 联盟;陪伴同事 
association	[əˌsoʊʃiˈeɪʃn, əˌsəʊʃiˈeɪʃn] n. 联想 
assume	[əˈsju:m, əˈsu:m] v. 承担 
assure	[əˈʃʊə(r), əˈʃʊr] vt. 向…保证 
astonish	[əˈstɒnɪʃ, əˈstɑ:nɪʃ] vt. 使惊讶，使大为吃惊 
at	[ət, æt,ət] prep. （表示位置）在;在（某时间或时刻） n. 阿特（老挝辅币单位，100 阿特 = 1 基普） 
Atlantic	[ətˈlæntɪk, ət'læntɪk] adj. 在大西洋里的，近大西洋的 n. （the Atlantic）大西洋 
atmosphere	[ˈætməsfɪr, ˈætməsfɪə(r)] n. 气氛 
atom	[ˈætəm] n. 原子 
attach	[əˈtætʃ] vt.&vi. 附上 vt. （有时不受欢迎或未受邀请而）参加 vi. 附着 
attack	[əˈtæk] vt.&vi. 攻击，进攻，抨击 n. 攻击 vt. 抨击 
attain	[əˈteɪn, əˈten] vt.&vi. 达到，获得 vt. 获得 vi. 达到 
attempt	[əˈtempt, əˈtɛmpt] vt. 尝试;试图 n. 进攻;尝试，冲击 
attend	[əˈtend, əˈtɛnd] vi. 出席;致力于，献身于 vt. 出席，参加;[常用被动语态]（作为结果、情况）伴随 
attendant	[əˈtɛndənt, əˈtendənt] n. 服务人员，侍者;随从，随员 adj. 伴随的，随之而产生的;出席的 
attention	[əˈtɛnʃən, əˈtenʃn] n. 注意，注意力;照料，关怀 int. [口令]立正 
attentive	[əˈtentɪv, əˈtɛntɪv] adj. 细心 
attitude	[ˈætɪtju:d, ˈætɪtu:d] n. 态度 
attorney	[əˈtɜ:rni, əˈtɜ:ni] n. 律师 
attract	[əˈtrækt] vt. 吸引;诱惑 vi. 具有吸引力;引人注意 
attractive	[əˈtræktɪv] adj. 迷人的 
attribute	[əˈtrɪbju:t, əˈtrɪbjut] vt. 认为…是 
audience	[ˈɔ:diəns, ˈɔdiəns] n. 观众 
August	[ˈɔ:gəst, 'ɔɡəst] adj. 尊严的，威严的，令人敬畏的;威风凛凛的 n. 八月（简写为Aug）;奥古斯特 
aunt	[ɑ:nt, ænt] n. 阿姨 
aural	[ˈɔ:rəl, ˈɔrəl] adj. 听觉的 
Australia	[ɒ'streɪlɪə, ɔˈstreljə] n. [地名][大洋洲]澳大利亚，澳洲 
Australian	[ɒˈstreɪliən, ɔˈstreljən] n. 澳大利亚人 adj. 澳大利亚的;澳大利亚人的 
author	[ˈɔ:θə(r), ˈɔθɚ] n. 作者;著作家 vt. 创作出版 
authority	[ɔ:ˈθɒrəti, əˈθɔ:rəti] n. 权威 
auto	[ˈɔ:toʊ, ˈɔ:təʊ] n. <美>汽车 vi. 乘汽车 
autumn	[ˈɔtəm, ˈɔ:təm] n. 秋;秋天 adj. 秋天的;秋季的 
available	[əˈveləbəl, əˈveɪləbl] adj. 可获得的 
avenue	[ˈævənju:, ˈævənu:] n. 大街 
average	[ˈævərɪdʒ, ˈævərɪdʒ, ˈævrɪdʒ] adj. 平均的 n. 平均水平 vt. [数学] 计算…的平均值 vi. 平均：作为或达到一个中间值 
avoid	[əˈvɔɪd] vt. 避开，避免，预防 
await	[əˈwet, əˈweɪt] vt. 等待 
awake	[əˈwek, əˈweɪk] adj. 醒着的;警惕的 vt.&vi. 唤醒;唤起 
award	[əˈwɔ:rd, əˈwɔ:d] vt. 授予，奖给，判给;判归，判定 n. 奖品;（仲裁人、公断人的）裁定 
aware	[əˈweə(r), əˈwer] adj. 意识到的 
away	[əˈwe, əˈweɪ] adv. 消失;离开，远离 adj. 不在的;遥远的 
awful	[ˈɔ:fl, ˈɔfəl] adj. 可怕的;糟糕的 adv. 非常，极 
awfully	[ˈɔ:fli, ˈɔflɪ] adv. 非常 
awkward	[ˈɔ:kwəd, ˈɔ:kwərd] adj. 笨拙的 
baby	[ˈbeɪbi] n. 婴儿 vt. 把…当作婴孩看待，娇养 adj. 孩子的 
back	[bæk] n. 背，背部 vt. 使后退 vi. 后退 adj. 后面的 adv. 以前 
background	[ˈbækgraʊnd, ˈbækˌɡraʊnd] n. （画等的）背景 
backwards	[ˈbækwərdz, ˈbækwədz] adj. 向后的;倒行的 adv. 向后;倒 
bacon	[ˈbeɪkən, ˈbekən] n. 培根 
bad	[bæd] adj. 坏的，不好的 n. 坏人，坏事 adv. 不好地，非常地 
badly	[ˈbædli] adv. 非常，在很大程度上 
badminton	[ˈbædˌmɪntən, ˈbædmɪntən] n. 羽毛球 
bag	[bæɡ, bæg] n. 袋，囊，枕套 vt. 把。。装入袋中，猎获 vi. 松散地垂挂 
baggage	[ˈbægɪdʒ, ˈbæɡɪdʒ] n. 行李 
bake	[bek, beɪk] vt. 烤，烘焙 vi. 烤，烘 n. 烤，烘焙 
bakery	[ˈbekəri, ˈbeɪkəri] n. 面包房，面包店 
balance	[ˈbæləns] n. 平衡 vt.&vi. 权衡 vt. 结平（账目） vi. 微微摇摆 
bald	[bɔ:ld, bɔld] adj. 秃头的 
ball	[bɔ:l, bɔl] n. 球 vt. 做成球状，使成团块 vi. 呈球形，成团块 
balloon	[bəˈlu:n, bəˈlun] n. 气球 vt. 膨胀，涨大 adj. 气球状的 vi. 乘气球飞行 
banana	[bəˈnɑ:nə, bəˈnænə] n. 香蕉 
band	[bænd] n. 带 vt. 给…镶边 vt.&vi. 结合起来，伙同 vi. 聚集，联合（起来）（通常与together 连用） 
bandage	[ˈbændɪdʒ] n. 绷带 vt. 用绷带绑扎 
bang	[bæŋ] n. 巨响 vt. 猛击，猛撞 vi. 发出砰的一声，砰砰作响，砰地敲[推，扔] adv. 正好，完全地 
bank	[bæŋk] n. 银行 vt.&vi. 堆积 vi. （转弯时）倾斜飞行 vt. （用煤等）封炉火 
bankrupt	[ˈbæŋkrʌpt, ˈbæŋkˌrʌpt, -rəpt] adj. 破产的，倒闭的 n. 破产者 vt. 使破产，使枯竭，使极端贫困 
banner	[ˈbænɚ, ˈbænə(r)] n. 横幅;标语 adj. 第一流的，第一位的;杰出的 
bar	[bɑ:(r), bɑ:r] n. 条，棒 vt. 闩（门等） prep. 除…之外 
barber	[ˈbɑ:bə(r), ˈbɑ:rbə(r)] n. 理发师 vt. 为…理发剃须 vi. 当理发师 
bare	[beə(r), ber] adj. 光秃秃的;赤裸的 vt. 使赤裸;使露出 
barely	[ˈbeəli, ˈberli] adv. 仅仅，勉强，好容易才 
bargain	[ˈbɑ:gən, ˈbɑ:rgən] n. 交易 vt. 做交易 vi. 讨价还价 
bark	[bɑ:k, bɑ:rk] vi. 吠叫 vt. 大声喊出 n. 树皮 
barn	[bɑ:rn, bɑ:n] n. 牲口棚 
barrel	[ˈbærəl] n. 桶 adj. 桶状的 vt. 装进桶里，放进桶里 vi. 高速行驶 
base	[bes, beɪs] n. 基地 vt. 基于 adj. 卑鄙的 
baseball	[ˈbeɪsbɔ:l, ˈbesˌbɔl] n. 棒球 
basement	[ˈbeɪsmənt, ˈbesmənt] n. 地下室 
basic	[ˈbeɪsɪk, ˈbesɪk] adj. 基本的;[化学]碱性的 n. 基础，基本;基本原则，基本原理，基本规律 
basin	[ˈbeɪsn, ˈbesɪn] n. 盆地 
basis	[ˈbeɪsɪs, ˈbesɪs] n. 基础 
basket	[ˈbæskɪt, ˈbɑ:skɪt] n. 篮;一篮 v. 把…装入篮内;把…丢入字纸篓里 
basketball	[ˈbɑ:skɪtbɔ:l, ˈbæskɪtbɔ:l] n. 篮球 
bat	[bæt] n. 蝙蝠;短棍，（棒球等的）球棒，（网球等的）球拍 vt.&vi. 用球板击球，用球棒击球（尤指板球或棒球运动） 
batch	[bætʃ] n. 一批 
bathe	[beð, beɪð] vt.&vi. 给…洗澡，游泳 vt. 冲洗 n. 游泳 
bathroom	[ˈbæθru:m, ˈbɑ:θru:m] n. 浴室 
battery	[ˈbætri, ˈbætəri] n. [电]电池，蓄电池 
battle	[ˈbætl] vt.&vi. 争斗;与…作战 n. 战争，战役;比赛，较量 
bay	[beɪ, be] n. 湾，海湾 vi. （尤指猎犬等）吠，叫，咆哮 adj. 赤褐色的，栗色的 vt. 向…吠叫 
BC	[ˌbi:'si:] abbr. before Christ 公元前（基督教会历法用） 
be	[bi] v. 是;有，存在 aux. 用来表示某人或某物即主语本身，用来表示某人或某物属于某一群体或有某种性质 
beach	[bitʃ, bi:tʃ] n. 海滩，海滨;岸上的沙子和卵石 vt. 将…拖上岸;将滑艇拖到小屋前面的岸边 
beam	[bi:m, bim] n. 束 vi. 发出光与热 vt. 播送 vt.&vi. 笑容满面，眉开眼笑 
bean	[bi:n, bin] n. 豆 vt. 将（球）击中击球员头部 int. 胡说！呸！不可能！ 
bear	[beə(r), ber] n. 熊 vt. 承担 vi. 生（孩子） adj. 跌价的 
beard	[bɪəd, bɪrd] n. 胡须;[虫]口鬃，[动]颌毛 vt. 使有胡须（颌毛，芒刺）;抓（捋）住…的胡子，拔…的胡子 
beast	[bi:st, bist] n. 野兽 
beat	[bit, bi:t] vi. （心脏等）跳动 vt.&vi. 接连地击打 vt. 打败 n. 节拍 adj. [美国口语]大吃一惊的 
beautiful	[ˈbjutəfəl, ˈbju:tɪfl] adj. 美丽的，美好的 
beauty	[ˈbju:ti, ˈbjuti] n. 美人 
because	[bɪˈkɔ:z, bɪˈkɒz] conj. 因为 
become	[bɪˈkʌm] vi. 变得;变成 vt. 变成;适合，适宜 
bed	[bed, bɛd] n. 床 vt. 把…固定在 vi. 上床 
bedroom	[ˈbedru:m, ˈbɛdˌrum, -ˌrʊm] n. 卧室，寝室 adj. <美>城郊住宅区的;两性关系的，男女性爱的 
bee	[bi:, bi] n. 蜜蜂 
beef	[bi:f, bif] n. 牛肉;菜牛（饲养以供肉食的牛） vi. 抱怨，大发牢骚 
beer	[bɪə(r), bɪr] n. 啤酒，麦酒 
before	[bɪˈfɔr,-ˈfor, bɪˈfɔ:(r)] prep. 在…之前 conj. 在…之前 adv. 先前，从前 
beforehand	[bɪˈfɔ:hænd, bɪˈfɔ:rhænd] adv. 提前;事先，预先 adj. 提前的;预先准备好的 
beg	[beg, bɛɡ] vt.&vi. 乞讨 
begin	[ˈbeɡɪn, bɪˈgɪn] vt.&vi. 开始;着手 vi. （从…）开始;起始 
beginner	[bɪˈɡɪnɚ, bɪˈgɪnə(r)] n. 新手，初学者 
beginning	[bɪˈgɪnɪŋ, bɪˈɡɪnɪŋ] n. 开始;根源 v. 开始( begin的现在分词) 
behalf	[bɪˈhæf, bɪˈhɑ:f] n. 利益 
behave	[bɪˈheɪv, bɪˈhev] vi. 表现;举止端正 vt. 使守规矩 
behaviour	[bɪˈhevjɚ, bɪˈheɪvjə(r)] n. 行为;举止 na. “behavior”的变体 
behind	[bɪˈhaɪnd] prep. （表示位置）在…的后面 adv. 在后面 n. 〈口〉屁股 
being	[ˈbi:ɪŋ, ˈbiɪŋ] n. 存在 
belief	[bɪˈli:f, bɪˈlif] n. 信，信任 
believe	[bɪˈli:v, bɪˈliv] v. 信任;料想 vt. 相信;信任 
bell	[bel, bɛl] n. 钟，铃 vt. 敲钟 vi. 使象钟状地张开 
belong	[bɪˈlɒŋ, bɪˈlɔ:ŋ] vi. 属于 
beloved	[bɪˈlʌvɪd, -ˈlʌvd, bɪˈlʌvd] adj. 亲爱的;被热爱的 n. 心爱的人，可爱的人;情人 
below	[bɪˈləʊ, bɪˈloʊ] adv. 在下面，到下面 prep. 低于;（表示位置）在…下面 
belt	[bɛlt, belt] n. 腰带;传送带 vt. 环绕，包围;用带做记号 
bench	[bɛntʃ, bentʃ] n. （木制）长凳，工作台;法官，法官席 vt. 给…以席位;为…设置条凳 
bend	[bɛnd, bend] vt. （使）弯曲，屈身 vi. 偏向 n. 弯道 
beneath	[bɪˈniθ, bɪˈni:θ] prep. 在…的下方;（表示等级）低于 adv. 在下面;在底下 
benefit	[ˈbenɪfɪt, ˈbɛnəfɪt] n. 利益，好处;救济金，津贴 vt. 有益于，有助于;使受益 
bent	[bɛnt, bent] adj. 弯曲的 n. 爱好，癖好 v. （使）弯曲，屈身(bend的过去式和过去分词) 
beside	[bɪˈsaɪd] prep. 不中（目标），不对（题），与…无关;（表示排斥）除…之外 adv. 〈古〉同“besides” 
besides	[bɪˈsaɪdz] adv. 此外;而且 prep. （表示排斥）除…之外（还有）;在…之外（还有），…之余兼 
best	[best, bɛst] adj. 最好的( good和well的最高级) adv. 最好地 n. 佼佼者 vt. [口]打败，胜过 
bet	[bet] n. 打赌，赌博，赌注 vi. 当然，的确 vt. 赌博 
betray	[bɪˈtreɪ, bɪˈtre] vt. 背叛 
better	[ˈbɛtɚ, ˈbetə(r)] adj. 较好的 adv. 更好地 v. 胜过 n. 更好者 
between	[bɪˈtwi:n, bɪˈtwin] prep. 在…之间;私下，暗中 adv. 当中，中间 
beware	[bɪˈwer, bɪˈweə(r)] v. 当心 
beyond	[bɪˈjɒnd, bɪˈjɑ:nd] prep. 超过 adv. 在远处 n. 远处 
Bible	[ˈbaɪbəl] n. 圣经 
bicycle	[ˈbaɪsɪkl] n. 自行车;脚踏车 v. 骑自行车 
bid	[bɪd] n. 出价，投标 vt.&vi. 出价， 投标 vt. 恳求 vi. 投标 
big	[bɪɡ, bɪg] adj. 大的 adv. 大量地 n. 大亨 
bill	[bɪl] n. 账单 vt. 安排 vi. 鸟嘴相接触 
billion	[ˈbɪljən] n. 十亿;数以十亿计 adj. （法美）十亿的;（英德）万亿的 
bind	[baɪnd] vt. 捆绑 vt.&vi. （使）结合 n. 捆绑 
biography	[baɪˈɒgrəfi, baɪˈɑ:grəfi] n. 传记 
bird	[bɜ:d, bɜ:rd] n. 鸟，禽;<俚>少女，姑娘，人，家伙，东西 vi. 观察和辨认鸟;捕鸟，打鸟 
birth	[bɜ:θ, bɜ:rθ] n. 出生 
birthday	[ˈbɜ:rθdeɪ, ˈbɜ:θdeɪ] n. 生日 
birthplace	[ˈbɜ:θpleɪs, ˈbɜ:rθpleɪs] n. 诞生地，出生地 
biscuit	[ˈbɪskɪt] n. <英>饼干 
bit	[bɪt] n. 一点，一块 adj. 很小的，微不足道的 adv. [口语]相当，有点儿，或多或少，多少[a bit to的省略] vt. 给（马）上嚼子 v. 咬，叮( bite的过去式) 
bite	[baɪt] vt.&vi. 咬 n. 咬 vi. 刺痛 vt. （辣椒，胡椒等）刺激 abbr. 机内测试设备(Built-In Test Equipment) 
bitter	[ˈbɪtə(r), ˈbɪtɚ] adj. 苦的 n. 苦 adv. 激烈地 vt. 使变苦 
black	[blæk] adj. 黑（色）的 n. 黑色 v. 使变黑 
blackboard	[ˈblækbɔ:d, ˈblækbɔ:rd] n. 黑板 
blame	[blem, bleɪm] vt. 归咎于;指责，责怪 n. 责备;责任 
blank	[blæŋk] adj. 空白的 n. 坯 vt. 消失 vi. 走神 
blanket	[ˈblæŋkɪt] n. 毛毯，毯子 adj. 总括的 vt. 用毯覆盖 
blast	[blæst, blɑ:st] n. 爆炸 vt. 击毁，摧毁 vi. 爆炸 
blaze	[bleɪz, blez] n. 火焰 vi. 猛烈地燃烧 vt. 在树片上刻痕指示（道路等） 
bleed	[bli:d, blid] vt. 使出血 vi. 流血 vt.&vi. 散开 n. [印]出血版 
bless	[blɛs, bles] vt. 祝福 
blind	[blaɪnd] adj. 失明的 vt. 弄瞎，使失明 n. 掩饰 adv. 盲目地 
block	[blɒk, blɑ:k] n. 块;街区 vt. 阻止;阻塞 
blood	[blʌd] n. 血，血液;流血，杀戮，杀人（罪），牺牲 vt. 用血染（皮革等），用血弄湿;使出血，抽…的血 
bloody	[ˈblʌdi] adj. 血腥的，残忍的 adv. 非常，很 v. 血污，血染 
bloom	[blum, blu:m] n. （常指供观赏的）花;开花期 vi. 开花;使植物繁盛 
blossom	[ˈblɒsəm, ˈblɑ:səm] n. 花，群花;开花时期，（发育的）初期 vi. （植物）开花;繁荣，兴旺 
blouse	[blaʊz, blaʊs] n. 短上衣;女衬衫 vt. 使…宽松下垂 
blow	[bləʊ, bloʊ] n. 殴打，打击 vt.&vi. （风）吹 vt. 吹，吹气 vi. 吹刮，吹动 
blue	[blu:, blu] n. 蓝色 adj. 蓝色的 vt. 把…染成蓝色 vi. 变成蓝色，呈蓝色 
blush	[blʌʃ] vi. 脸红，惭愧;变红 n. 脸红，红色;<古>一见，一瞥 
board	[bɔ:d, bɔ:rd] n. 板 vt. 上（船、车或飞机） vi. （火车、轮船、飞机等）接受乘客 
boast	[bəʊst, boʊst] vt. 夸口说;自夸，自吹自擂 n. 夸口，自负;自负的事物，引以为傲的东西 
boat	[bəʊt, boʊt] n. 小船，小艇 vi. 乘船，划船 vt. 用船运输 
body	[ˈbɑ:di, ˈbɒdi] n. 身体;尸体 vt. 赋予形体 
boil	[bɔɪl] n. 煮沸，沸腾 vt.&vi. （使）沸腾，开 vt. 用开水煮，在沸水中煮 vi. 怒火中烧，异常气愤 
boiler	[ˈbɔɪlɚ, ˈbɔɪlə(r)] n. 锅炉 
bold	[bəʊld, boʊld] adj. 明显的，醒目的;勇敢的，无畏的 n. 粗体字;黑体字 
bomb	[bɒm, bɑ:m] n. 炸弹 vt. 轰炸，投弹于 vi. 投弹 
bond	[bɑ:nd, bɒnd] n. 债券;纽带 v. 使结合;建立互信关系 
bone	[bəʊn, boʊn] n. 骨头 vt. 挑鱼刺，剔骨头 vi. 苦学 
book	[bʊk] n. 书 vt.&vi. 预订 vt. 登记 adj. 书的 
boot	[but, bu:t] n. 长靴，皮靴 vt. 穿（靴） vi. 帮助或益处 
booth	[bu:ð, bu:θ] n. 售货棚，摊位 
border	[ˈbɔ:rdə(r), ˈbɔ:də(r)] n. 边界 vt.&vi. 与…接界，在…的边上 vt. 沿…的边，环绕…，给…镶边 vi. 近似，毗邻 
born	[bɔ:rn, bɔ:n] vt. bear的过去分词 vi. 结果，生产 adj. 出生的，出身于…的 
borrow	[ˈbɒrəʊ, ˈbɑ:roʊ] vt.&vi. 借入;借钱，借用 n. 借，借用;担保物，抵押 
bosom	[ˈbʊzəm, ˈbuzəm, ˈbʊzəm] n. 胸怀 vt. 怀抱 adj. 心爱的 
boss	[bɒs, bɔ:s] n. 老板，上司 vt. 当…的首领 vi. 当首领 adj. <俚>很好的，一流的 
both	[bəʊθ, boʊθ] adj. 二者，两者都 pron. 二者 adv. 二者，二者都 conj. 不仅…而且…，…和…都 
bother	[ˈbɒðə(r), ˈbɑ:ðə(r)] vt. 烦恼 vi. 麻烦 n. 麻烦，操心 
bottle	[ˈbɒtl, ˈbɑ:tl] n. 瓶子 vt. 把…装入瓶中 vi. （街头艺人演出后）收拢钱币 
bottom	[ˈbɑ:təm, ˈbɒtəm] n. 底部 adj. 底部的 vt. 装底 vi. 到达底部 
bound	[baʊnd] vi. 跳，弹跳 vt. 束缚 n. 界限，限制 adj. 用带子绑住的 
boundary	[ˈbaʊndri, ˈbaʊndəri, -dri] n. 分界线 
bow	[boʊ, bəʊ] n. 弓 
bowl	[bəʊl, boʊl] n. 碗 vi. 参加保龄球赛 vt. 投掷或滚动（球） 
box	[bɑ:ks, bɒks] n. 盒 vt. 把…装入盒[箱，匣]中 vt.&vi. 拳击 
boy	[bɔɪ] n. 儿子 
brain	[breɪn, bren] n. 脑;智慧 vt. 打破…的脑袋;打…的头部 
brake	[breɪk, brek] n. 刹车;制动器，闸 vt.&vi. 刹（车） 
branch	[bræntʃ, brɑ:ntʃ] n. 分支 vi. 分支形成 vt. 使分支 
brand	[brænd] n. [商]商标，牌子;烙印 vt. 污辱;铭刻于 
brass	[brɑ:s, bræs] n. 黄铜;铜管乐器 v. 〈英〉付（款）;[冶]把…包铜 
brave	[breɪv, brev] adj. 勇敢的 vt. 勇敢面对，不怕，不顾 n. 勇士 
bravery	['breɪvərɪ, ˈbrevəri, ˈbrevri] n. 勇敢，勇气 
bread	[bred, brɛd] n. 面包;食物 vt. 在…上撒面包屑 
break	[breɪk, brek] vt. （使）破 vi. 突破 n. 破裂 
breakfast	[ˈbrekfəst] n. 早餐，早饭 vi. 吃早餐 vt. 供给…早餐 
breast	[brest, brɛst] n. 乳房，乳腺;胸脯，胸部 vt. 升高，攀登;坚毅地面对，与…搏斗 
breath	[breθ, brɛθ] n. 呼吸 
breathe	[bri:ð, brið] vi. 呼吸;活着，生存 vt. 呼吸;吸进（如香气） 
breed	[bri:d, brid] vt. 产（后代），生 vi. 产仔 n. 属 
brick	[brɪk] n. 砖，砖块 vt. 用砖建造、砌或铺 adj. 用砖做的 
bride	[braɪd] n. 新娘，即将（或刚刚）结婚的女子 
bridegroom	[ˈbraɪdgru:m, ˈbraɪdˌɡrum,-ˌɡrʊm] n. 新郎 
bridge	[brɪdʒ] n. 桥;桥牌 vt. 在…建桥，架桥于…之上;通过桥横跨 
brief	[bri:f, brif] adj. 短暂的 vt. 向…介绍基本情况 n. 概要 
bright	[braɪt] adj. 明亮的，鲜亮的 adv. 明亮地，光明地，光亮地 n. 车头灯 
brilliant	[ˈbrɪliənt, ˈbrɪljənt] adj. 才华横溢的;明亮的 n. 宝石;钻石 
bring	[brɪŋ] vt. 导致 
brisk	[brɪsk] adj. 轻快的 vi. 活跃起来 vt. 使…活泼 
Britain	[ˈbrɪtn] n. 不列颠，英国 
British	[ˈbrɪtɪʃ] adj. 英国的;英国人的 n. （总称）英国人;英国英语 
brittle	[ˈbrɪtl] adj. 易碎的 
broad	[brɔd, brɔ:d] adj. 广泛的;宽阔的 n. 婆娘 
broadcast	[ˈbrɔ:dkæst, ˈbrɔ:dkɑ:st] vt. 广播 vi. 播放节目 n. 广播 adj. 广播的 
brook	[brʊk] vt. 容忍，忍受 n. 小溪 
broom	[bru:m, brum,brʊm] n. 扫帚 vt. 扫除 vi. 桩顶开花或开裂 
brother	[ˈbrʌðɚ, ˈbrʌðə(r)] n. 兄弟;同事，同胞 int. （表示生气或吃惊）我的老兄！ 
brow	[braʊ] n. 前额 
brown	[braʊn] adj. 棕色的 n. 棕色 v. 变成棕色 
brush	[brʌʃ] n. 刷子，画笔 vt. 刷 vi. 刷 
brutal	[ˈbrutl, ˈbru:tl] adj. 残忍的 
bubble	[ˈbʌbəl, ˈbʌbl] n. 泡，水泡 vt.&vi. 起泡，使冒气泡 vi. 使冒泡，发出冒泡的声音 
bucket	[ˈbʌkɪt] n. 水桶;一桶（的量） v. 用桶装，用桶运;倾盆而下 
bud	[bʌd] n. 芽，萌芽;蓓蕾，骨朵 vi. 发芽，长出蓓蕾;开始发育 
budget	[ˈbʌdʒɪt] n. 预算 vt.&vi. 把…编入预算 adj. 价格低廉的 vt. 在预算中拨款给 vi. 做安排(for) 
buffet	[ˈbʊfeɪ, bəˈfeɪ] n. 自助餐 
build	[bɪld] vt. 建立 vi. 建造，营造 n. 体格，构造 
building	[, ˈbɪldɪŋ] n. 建筑物;房屋 v. build的现在分词 
bulb	[bʌlb] n. 电灯泡 
bull	[bʊl] n. 公牛 vt. [证券]从事投机使（证券等）价格上涨 vi. [证券]（证券、股票等）价格上涨 adj. 公的，雄的 
bullet	[ˈbʊlɪt] n. 弹丸 
bulletin	[ˈbʊlətɪn, ˈbʊlɪtn, -tɪn] n. 公告，公报;新闻快报 vt. 公布，公告;用公报发表 
bunch	[bʌntʃ] n. 束，串，捆 vt. 聚成一串，形成一串 vi. 形成一串，形成一组 
bundle	[ˈbʌndl] n. 捆 vt.&vi. 收集，归拢，把…塞入 vt. 额外免费提供（设备等），（尤指出售计算机时）赠送软件 vi. 匆匆送走 
burden	[ˈbɜ:dn, ˈbɜ:rdn] n. 负担，包袱;责任，义务 vt. 使烦恼，劳累;向（车，船等）上装货 
bureau	[ˈbjʊərəʊ, ˈbjʊroʊ] n. 局 
burn	[bɜ:rn, bɜ:n] vt.&vi.&link-v. （使）燃烧 vt.&vi. 烧伤 n. 烧伤，烧痕 
burst	[bɜ:st, bɜ:rst] vi. 爆发 vt. 使爆炸 n. 突发 
bury	[ˈberi, ˈbɛri] vt. 埋葬，葬;为…举行葬礼 n. 布里 
bus	[bʌs] n. 公共汽车，巴士，客机 vt. 用公共汽车运送 vi. 乘公共汽车 
bush	[bʊʃ] n. 灌木（丛） vi. 丛生 vt. 加（金属）衬套于 adj. （豆科植物等）如灌木般长得低矮的 
business	[ˈbɪznɪs, ˈbɪznəs] n. 生意 
busy	[ˈbɪzi] adj. 忙碌的 vt. 忙着做某事 n. 〈英俚〉侦探 
but	[bət, bʌt,bət] conj. 但是 prep. 除…以外 adv. 不过 n. 但是 pron. [关系代词，意义相当于 who…not
butcher	[ˈbʊtʃə(r), ˈbʊtʃɚ] n. 肉铺;屠夫，屠户 vt. 屠宰;屠杀 
butter	[ˈbʌtə(r), ˈbʌtɚ] n. 黄油;黄油状的食品 vt. 抹黄油于…上;用黄油煎食物 
butterfly	[ˈbʌtəflaɪ, ˈbʌtərflaɪ] n. 蝴蝶;蝶泳 v. 切开摊平 
button	[ˈbʌtn] n. 按钮，电钮 vt. 用纽扣扣紧 vi. 扣住 
buy	[baɪ] vt.&vi. 购买，购得 n. 交易，买卖 vt. 够支付 
by	[baɪ] prep. 在…旁边;表示方式 adv. 经过;表示保留或保存时用 
bye-bye	['baɪˌbaɪ, ˈbaɪˌbaɪ, baɪˈbaɪ] int. 再见 
cabbage	[ˈkæbɪdʒ] n. 甘蓝（洋白菜、卷心菜） 
cabin	[ˈkæbɪn] n. 客舱 vt. 把…关在小屋里 vi. 住在小屋里 
cabinet	[ˈkæbɪnət, ˈkæbənɪt] n. 内阁;柜橱 adj. 内阁的;秘密的 
cable	[ˈkebəl, ˈkeɪbl] n. 缆绳，绳索 vt. 发电报至 vi. 拍发电报 
cafe	[ˈkæfeɪ, kæˈfeɪ] n. 咖啡馆，小餐厅 
cafeteria	[ˌkæfəˈtɪriə, ˌkæfəˈtɪəriə] n. 自助餐厅 
cage	[keɪdʒ, kedʒ] n. 笼子;牢房 vt. 把…关入牢中;把…关进笼内 
cake	[keɪk] n. 蛋糕;糕饼 vt.&vi. （使）结块;（使）胶 
cal	[] abbr. small calorie 卡，小卡 
calculate	[ˈkælkjuleɪt, ˈkælkjəˌlet] vt.&vi. 计算;估计 vt. 预测，推测 
calendar	[ˈkælɪndə(r), ˈkæləndɚ] n. 日历;历法 vt. 把…记入日程表中;把…列入表中 
call	[kɔ:l, kɔl] v. 打电话给;呼唤，喊叫 n. 喊叫，大声喊;电话联络 
calm	[kɑ:m, kɑm] adj. 平静的 vt.&vi. （使）平静，（使）镇定 n. 平静 vt. 使安静 vi. 安静下来，平静下来，镇静下来 
camel	[ˈkæməl, ˈkæml] n. 骆驼 
camera	[ˈkæmərə, ˈkæmərə, ˈkæmrə] n. 照相机 
camp	[kæmp] n. 营地，工地宿舍 vt.&vi. 宿营，露营 adj. 夸张的 vi. （尤指在假日）野营 vt. 使扎营（住宿） 
campaign	[kæmˈpen, kæmˈpeɪn] n. 运动;战役 vi. 作战;参加[发起]运动，参加竞选 
campus	[ˈkæmpəs] n. 校园 
can	[kæn] aux. 可以 vt. 将…装入密封罐中保存 n. 罐头 
Canada	[ˈkænədə, 'kænədə] n. 加拿大 
Canadian	[kəˈneɪdiən, kəˈnediən] adj. 加拿大的;加拿大人的 n. 加拿大人 
canal	[kəˈnæl] n. 运河，沟渠;管道 vt. 建运河;疏导 
cancel	[ˈkænsl, ˈkænsəl] vt. 取消，注销 vi. 抵消，中和 n. 撤销，注销 
cancer	[ˈkænsə(r), ˈkænsɚ] n. 癌症，恶性肿瘤 
candidate	[ˈkændɪdət, ˈkændɪˌdet, -dɪt] n. 报考者 
candle	[ˈkændl] n. 蜡烛;烛光 vt. 对光检查 
candy	[ˈkændi] n. 糖果 vt. （用糖煮过以）保存 adj. 〈美俚〉（服饰）花哨的 
cannon	[ˈkænən] n. 大炮 vi. 与…猛撞 vt. 炮轰 
canoe	[kəˈnu:, kəˈnu] n. 独木舟，轻舟 vt. 用独木舟运送 vi. 划（乘）独木舟 
cap	[kæp] n. 盖 vi. 脱帽致意 vt. 覆盖 abbr. Common Agricultural Policy （欧共体）共同农业政策 
capable	[ˈkepəbəl, ˈkeɪpəbl] adj. 能干的;有才能的 n. 有才能的，能干的 
capacity	[kəˈpæsəti, kəˈpæsɪti] n. 容量;性能 adj. 充其量的，最大限度的 
capital	[ˈkæpɪtl] n. 资本;首都 adj. 资本的;首都的 
captain	[ˈkæptən, ˈkæptɪn] n. 上尉;船长，机长 vt. 当首领;统帅或指挥 
capture	[ˈkæptʃə(r), ˈkæptʃɚ] vt. 俘获;夺取 n. 捕获;占领 
car	[kɑr, kɑ:(r)] n. 汽车 
card	[kɑ:rd, kɑ:d] n. 卡片;信用卡 vt. 记于卡片上 
care	[ker, keə(r)] v. 照顾;关心 n. 照顾;小心 
career	[kəˈrɪə(r), kəˈrɪr] n. 职业 adj. 作为毕生职业的 vi. 全速前进，猛冲 
careful	[ˈkeəfl, ˈkerfl] adj. 仔细的，小心的 
careless	[ˈkeələs, ˈkerləs] adj. 粗心的 
cargo	[ˈkɑ:rgoʊ, ˈkɑ:gəʊ] n. （船或飞机装载的）货物 
carpet	[ˈkɑ:rpɪt, ˈkɑ:pɪt] n. 地毯，桌毯;毛毯，绒毯 vt. 在…上铺地毯;把地毯铺在…上 
carriage	[ˈkærɪdʒ] n. 运费 
carrot	[ˈkærət] n. 胡萝卜 
carry	[ˈkæri] vt. 携带 vt.&vi. 运送 vi. （文学、戏剧等）对读者 n. （枪炮、火箭等的）射程 
cart	[kɑ:rt, kɑ:t] n. 运货马车，手推车;一车之量 vt. 用推车或卡车运送;费力搬运 
cartoon	[kɑ:ˈtu:n, kɑ:rˈtu:n] n. 漫画 vt. 为…画漫画 vi. 画漫画 
carve	[kɑ:rv, kɑ:v] vi. 雕刻;切，切开 vt. 雕塑;切片 
case	[kes, keɪs] n. （实）例，事例;情况，状况 vt. 把…装入箱（或盒等）内;加盖于 
cash	[kæʃ] n. 现金 vt. 兑现 adj. 现金的 
cashier	[kæˈʃɪə(r), kæˈʃɪr] n. 出纳员 vt. 解雇;抛弃 
cassette	[kəˈset, kəˈsɛt, kæ-] n. 盒式录音带 
cast	[kæst, kɑ:st] vt. 铸造 n. 铸型 vi. 掷，投 
castle	[ˈkɑ:sl, ˈkæsl] n. 城堡，堡垒;象棋中的车 vt. 把…置于城堡中;（下国际象棋时）用车护（王） 
casual	[ˈkæʒuəl] adj. 随便的;偶然的 n. 临时工人;[军]待命士兵 
casualty	[ˈkæʒuəlti] n. 伤亡（人数） 
cat	[kæt] n. 猫;猫科动物 vt. 把（锚）吊放在锚架上;〈俚〉寻欢，宿娼 
catalogue	[ˈkætlˌɔɡ, -ˌɑɡ, ˈkætəlɒg] n. 目录，一览表;（美）大学情况便览 vt. 为…编目录;登记分类 
catch	[kætʃ, kætʃ, kɛtʃ] vt. 赶上 vt.&vi. （使）被钩住，（使）被卡住 n. 抓 vi. 锁住 adj. 迷惑人的 
category	[ˈkætəgɔ:ri, ˈkætəgəri] n. 类型，部门，种类，类别，类目 
cathedral	[kəˈθi:drəl, kəˈθidrəl] n. 总教堂，大教堂 adj. 教堂的;权威的 
Catholic	[ˈkæθəlɪk, ˈkæθlɪk, ˈkæθlɪk] adj. 天主教的;统括一切的 n. 旧教徒;旧教信奉者 
cattle	[ˈkætl] n. （总称）牛，牲口 
cause	[kɔ:z, kɔz] n. 原因;事业 vt. 引起;导致 
caution	[ˈkɔʃən, ˈkɔ:ʃn] n. 警告;小心 vt. 警告;提醒 
cautious	[ˈkɔ:ʃəs, ˈkɔʃəs] adj. 小心的，谨慎的 
cave	[keɪv, kev] n. 洞穴 vt.&vi. （使）塌陷，倒塌 vi. 屈服 
cease	[sis, si:s] vt. 停止，终止，结束 vi. 终止，停止 n. 停止 
ceiling	[ˈsi:lɪŋ, ˈsilɪŋ] n. 天花板 
celebrate	[ˈsɛləˌbret, ˈselɪbreɪt] v. 庆祝 
cell	[sɛl, sel] n. 电池 vi. 住在牢房或小室中 vt. 囚禁 
cellar	[ˈsɛlɚ, ˈselə(r)] n. 酒窖;地下室，地窖 vt. 把…藏入地窖（酒窖） 
cement	[sɪˈmɛnt, sɪˈment] n. 水泥;胶合剂 vt. 巩固;粘牢 
cent	[sent, sɛnt] n. 分 
center	[ˈsɛntɚ, 'sentə] n. 中心 adj. 中央的，位于正中的 vt. 集中 vi. 居中，有中心，被置于中心 
central	[ˈsentrəl, ˈsɛntrəl] adj. 中央的，中心的;重要的，核心的 n. 电话总局;电话转接员 
century	[ˈsɛntʃəri, ˈsentʃəri] n. 百年，一世纪 
ceremony	[ˈserəmoʊni, ˈserəməni] n. 典礼，仪式 
certain	[ˈsɜ:tn, ˈsɜ:rtn] adj. 某一;必然的 pron. [动词用复数]某些 
certainly	[ˈsɜ:tnli, ˈsɜ:rtnli] adv. 肯定 
certainty	[ˈsɜ:tnti, ˈsɜ:rtnti] n. 确定性，确实性 
certificate	[səˈtɪfɪkət, sərˈtɪfɪkət] n. 证明书;文凭，结业证书 vt. 发给证明书;用证书证明（或认可） 
chain	[tʃeɪn, tʃen] n. 链子，链条;连锁，连续 vt. 用铁链锁住;监禁，束缚 
chair	[tʃeə(r), tʃer] n. 椅子;大学教授职位 vt. 主持;使…入座 
chairman	[ˈtʃeəmən, ˈtʃermən] n. （主持会议的）主席;委员长 vt. 担任…的主席 
chalk	[tʃɔk, tʃɔ:k] n. 粉笔，白垩;用粉笔画的记号 v. 用粉笔写（记下）;用白垩粉擦（桌球杆等） 
challenge	[ˈtʃæləndʒ] n. 挑战 vt. 质疑 vi. 提出挑战，要求竞赛（或竞争） 
chamber	[ˈtʃembɚ, ˈtʃeɪmbə(r)] n. 室，卧室，会客室;内庭 vt. 限制，幽禁，封闭或限制;使备有房间 
champion	['tʃæmpɪən, ˈtʃæmpiən] n. 冠军 vt. 为…而斗争，捍卫，声援 adj. 优胜的 
chance	[tʃɑ:ns, tʃæns] n. 机会，机遇 v. 偶然发生 adj. 偶然的 
chancellor	['tʃɑ:nsələ(r), ˈtʃænsəlɚ, -slɚ] n. 大臣 
change	[tʃeɪndʒ, tʃendʒ] vt. 改变，变更 vi. 改变，转变 n. 变化，改变 
changeable	[ˈtʃeɪndʒəbl, ˈtʃendʒəbəl] adj. 可变的 
channel	[ˈtʃænəl, ˈtʃænl] n. 渠道;海峡 vt. 引导，开导;形成河道 
chaos	[ˈkeɪɒs, ˈkeɪɑ:s] n. 混乱，紊乱 
chapter	[ˈtʃæptə(r), ˈtʃæptɚ] n. 章，回;（俱乐部、协会等的）分会 vt. 把…分成章节 
character	[ˈkærəktə(r), ˈkærəktɚ] n. 性格;角色 vt. 刻，印;使具有特征 
characteristic	[ˌkærəktəˈrɪstɪk] adj. 特有的;独特的 n. 特性，特征，特色，[数]（对数的）首数;独特性 
characterize	[ˈkærəktəraɪz, ˈkærəktəˌraɪz] vt. 描述（人或物）的特性;具有…的特征 vi. 塑造人物 
charge	[tʃɑ:dʒ, tʃɑ:rdʒ] vt. 装载 vi. 充电 n. 电荷 
charm	[tʃɑ:m, tʃɑ:rm] n. 魅力;魔力 vt. 使陶醉;诱惑 
charming	[ˈtʃɑ:rmɪŋ, ˈtʃɑ:mɪŋ] adj. 迷人的，可爱的;英俊的，潇洒的 v. 使高兴;使陶醉，使着迷 
chart	[tʃɑ:t, tʃɑ:rt] n. 图表;航海图 vt. 绘制地图;记录 
chase	[tʃeɪs, tʃes] vt. 追求 n. 追捕 vi. 追逐，追赶 
chat	[tʃæt] vi. 聊天 n. （尤指非正式的）谈话 vt. 与…攀谈 
cheap	[tʃi:p, tʃip] adj. 便宜的，廉价的;劣质的，低劣的 adv. 便宜地;卑鄙地 
cheat	[tʃi:t, tʃit] vt. 欺骗，诈骗 vi. 作弊，行骗 n. 骗子 
check	[tʃɛk, tʃek] vt. 检查，核对 vi. 核实，查核 n. <美>支票 
cheek	[tʃi:k, tʃik] n. 脸颊，脸蛋;无礼而放肆的行为，厚颜 vt. 对…无礼地说话 
cheer	[tʃɪə(r), tʃɪr] vt. 欢呼 n. 欢呼，喝彩 vi. 欢呼 
cheese	[tʃi:z, tʃiz] n. 奶酪;<俚>微笑 vt. <俚>停止 
chemical	[ˈkemɪkl, ˈkɛmɪkəl] adj. 化学的;用化学方法制造的，化学作用的 n. 化学药品，化学制品 
chemist	[ˈkemɪst, ˈkɛmɪst] n. 化学家 
chemistry	[ˈkemɪstri, ˈkɛmɪstri] n. 化学 
cherish	[ˈtʃerɪʃ, ˈtʃɛrɪʃ] vt. 珍爱 
cherry	[ˈtʃɛri, ˈtʃeri] n. 樱桃 
chess	[tʃɛs, tʃes] n. 棋，国际象棋 
chest	[tʃɛst, tʃest] n. 箱子 
chew	[tʃu:] vt.&vi. 咀嚼，咬;深思，考虑 n. 咀嚼;咀嚼物 
chicken	[ˈtʃɪkɪn, ˈtʃɪkən] n. 鸡 adj. 胆怯的 vi. 以畏缩的方式去做，失去勇气 
chief	[tʃi:f, tʃif] adj. 主要的;级别最高的 n. 首领;酋长 
child	[tʃaɪld] n. 小孩，孩子 
childhood	[ˈtʃaɪldˌhʊd, ˈtʃaɪldhʊd] n. 童年，儿童时代 
childish	[ˈtʃaɪldɪʃ] adj. 幼稚的 
chill	[tʃɪl] vt.&vi. （使）变冷 n. 寒冷，发冷 adj. 冷的 vt. 令失望 
chimney	[ˈtʃɪmni] n. 烟囱 
chin	[tʃɪn] n. （尤指人的）颏，下巴;聊天 v. 用下巴夹住;聊天 
China	['tʃaɪnə, ˈtʃaɪnə] n. 中国;[电影]中国1971  [地名] [墨西哥] 奇纳;[地名] [俄罗斯] 奇纳河 
Chinese	[ˌtʃaɪˈni:z, tʃaɪˈniz, -ˈnis] n. 中文;汉语 adj. 中国的;中文的 
chip	[tʃɪp] n. 碎片 vt. 刻，削成 vi. 剥落 
chocolate	[ˈtʃɑ:klət, ˈtʃɒklət] n. 巧克力;巧克力色 adj. 巧克力色的;（含有）巧克力的 
choice	[tʃɔɪs] n. 选择;选择权 adj. 上等的，精选的 
choose	[tʃu:z, tʃuz] vt. 挑选;认为…比其它更可取 vi. 选择;进行挑选 
chorus	[ˈkɔ:rəs, ˈkɔrəs, ˈkor-] n. 合唱;合唱队 vt. 合唱;齐声背诵 
Christian	[ˈkrɪstʃən] n. 基督教徒，信徒;克里斯琴 adj. 信基督教的，基督教的，基督教徒的;<口>人（类）的，文明的，<口>正派的，高尚的 
Christmas	[ˈkrɪsməs] n. 圣诞节 
church	[tʃɜ:tʃ, tʃɜ:rtʃ] n. [宗]教堂 adj. 教会的 vt. 领…到教堂接受宗教仪式 
cigar	[sɪˈgɑ:(r), sɪˈɡɑr] n. 雪茄 
cigarette	[ˌsɪgəˈret, ˈsɪgəret] n. 纸烟，香烟 
cinema	[ˈsɪnəmə] n. 电影 
circle	[ˈsɜ:kl, ˈsɜ:rkl] n. 圆 vt. 圈出，包围 vi. 环绕，盘旋 
circular	[ˈsɜ:rkjələ(r), ˈsɜ:kjələ(r)] adj. 圆形的;环行的 n. 通知，通告;印制的广告，传单 
circulate	[ˈsɜ:kjəleɪt, ˈsɜ:rkjəleɪt] vt.&vi. （使）循环;（使）流通 vi. 传送，传递，传阅 
circumstance	[ˈsɜ:rkəmstæns, ˈsɜ:kəmstəns] n. 环境，境遇;事实，细节 vt. 使处于某种特定的情况之下 
circus	[ˈsɜ:kəs, ˈsɜ:rkəs] n. 马戏，马戏团 
cite	[saɪt] vt. 引用，引证;[法]传讯 n. <口>例证，引文 
citizen	[ˈsɪtɪzən, ˈsɪtɪzn] n. 公民 
city	[ˈsɪti] n. 城市 
civil	[ˈsɪvl, ˈsɪvəl] adj. 公民的，市民的 
civilization	[ˌsɪvəlaɪˈzeɪʃn, ˌsɪvələˈzeɪʃn] n. 文明社会 
civilize	[ˈsɪvəˌlaɪz, ˈsɪvəlaɪz] vt. 教化;使文明 vi. 变得文明 
claim	[kleɪm, klem] vt. 声称 vi. 提出要求 n. 索赔 
clap	[klæp] vt.&vi. 拍手，鼓掌 n. 鼓掌，拍手 vi. 鼓掌，拍手 
clarify	[ˈklærəfaɪ, ˈklærəˌfaɪ] vt.&vi. 使清楚，澄清 vt. 说明 vi. （液体）变得澄清 
clasp	[klɑ:sp, klæsp] n. 拥抱;扣钩，扣环 vt.&vi. 紧握;扣住 
class	[klɑ:s, klæs] n. 班 vt. 把…归入某等级，把…看作（或分类、归类） adj. 很好的，优秀的，出色的 vi. 属于…类（或等级），被列为某类（或某级） 
classic	[ˈklæsɪk,  ˈklæsɪk] adj. 典型的;传统式样的 n. 文豪;文学名著 
classical	[ˈklæsɪkl, ˈklæsɪkəl] adj. 传统的;古典的，经典的 n. 古典音乐 
classify	[ˈklæsəˌfaɪ, ˈklæsɪfaɪ] vt. 分类，归类 
classmate	[ˈklæsmeɪt, ˈklɑ:smeɪt] n. （同班）同学 
classroom	[ˈklæsru:m, ˈklɑ:sru:m] n. 教室，课堂 
clay	[kleɪ, kle] n. 黏土，泥土;（相对于灵魂而言的）人体，肉体 vt. 用黏土处理 
clean	[klin, kli:n] adj. 清洁的 vt.&vi. （使）清洁 vi. 清扫 adv. 完全地，彻底地 n. 打扫 
clear	[klɪə(r), klɪr] adj. 明确的 adv. 完全地 vi. 变明朗 vt. 扫除，除去 n. 空隙，空间 
clerk	[klɑ:k, klɜ:rk] n. 店员;书记员 vi. 当职员;当销售员 
clever	[ˈklevə(r), ˈklɛvɚ] adj. 聪明的，灵巧的 
client	[ˈklaɪənt] n. 顾客 
cliff	[klɪf] n. 悬崖，峭壁 
climate	[ˈklaɪmɪt, ˈklaɪmət] n. 气候 
climax	[ˈklaɪmæks, ˈklaɪˌmæks] n. 高潮;顶点，极点 vt.&vi. 达到顶点;达到巅峰 
climb	[klaɪm] v. 爬;攀登 n. 攀登;山，岩 
cling	[klɪŋ] vi. 坚持;附着于，紧贴 vt. 依恋，依附于 
clinic	[ˈklɪnɪk] n. 诊所，门诊部 
cloak	[kloʊk, kləʊk] n. 披风，斗篷;外套 vt. 遮盖，掩盖;用外衣遮蔽 
clock	[klɒk, klɑ:k] n. 钟，时钟 vt. 记录（时间或速度） vi. 打卡 
close	[kloʊz, kləʊz] adj. 亲密的 vt. 关 vi. 关闭 adv. 紧密地 n. 结束 
cloth	[klɔ:θ, klɒθ] n. 布，织物 
clothes	[kloʊðz, kləʊðz] n. 衣服，衣物;寝具 v. 穿（衣）( clothe的第三人称单数);给…提供衣服 
clothing	[ˈkləʊðɪŋ, ˈkloʊðɪŋ] n. 服装;衣服 v. 覆盖(clothe的现在分词);给…提供衣服 
cloud	[klaʊd] n. 云 vi. 布满云 vt. 使难以理解 
cloudy	[ˈklaʊdi] adj. 多云的 
club	[klʌb] n. 社团 vt. 联合 vi. 组成俱乐部 adj. 俱乐部的 
clue	[klu:, klu] n. 线索;提示 vt. <非正>为…提供最新情况（消息等） 
clutch	[klʌtʃ] vt. 抓住 vi. 试图抓住 adj. 紧要关头的 n. 离合器 
coach	[kəʊtʃ, koʊtʃ] n. 教练 vt.&vi. 辅导 vt. 指导 vi. 作指导 
coarse	[kɔ:rs, kɔ:s] adj. 粗糙的 
coast	[koʊst, kəʊst] n. 海岸 vi. （汽车或自行车）（尤指不用动力向山坡下）滑行 vt. 沿海岸航行 
coat	[koʊt, kəʊt] n. 上衣，外套 vt. 给…穿上上衣[外套];盖上 
cock	[kɒk, kɑ:k] n. 公鸡 vt. 使某物竖起 vi. 翘起，竖起 
code	[koʊd, kəʊd] n. 法典 vt. 将…译成电码 vi. 为…编码 
coherent	[kəʊˈhɪərənt, koʊˈhɪrənt] adj. 连贯的 
coil	[kɔɪl] n. 线圈 vt. 盘绕 vi. 绕成盘状 
coin	[kɔɪn] n. 硬币;金属钱币 vt. 制造硬币;杜撰 
coincide	[ˌkəʊɪnˈsaɪd, ˌkoʊɪnˈsaɪd] vi. 相符 
coke	[kəʊk, koʊk] n. 焦炭，焦煤 vt.&vi. 转化或者被转化为焦炭 
cold	[koʊld, kəʊld] adj. 寒冷的 n. 寒冷 adv. 完全地 
collaborate	[kəˈlæbəˌret, kəˈlæbəreɪt] vi. 合作，协作 
collapse	[kəˈlæps] vi. 崩溃 vt. 使倒塌 n. 垮台 
collar	[ˈkɑ:lə(r), ˈkɒlə(r)] n. 衣领;领子 vt. 抓住，逮住;扭住领口 
colleague	[ˈkɒli:g, ˈkɑli:g] n. 同事 
collect	[kəˈlɛkt, kəˈlekt] vt. 收集 vi. 募捐 adj. 由受话人付费的 
collection	[kəˈlekʃn, kəˈlɛkʃən] n. 征收 
collective	[kəˈlektɪv, kəˈlɛktɪv] adj. 集体的;共同的 n. [统]集体;[语]集合名词 
college	[ˈkɑ:lɪdʒ, ˈkɒlɪdʒ] n. 大学 
collision	[kəˈlɪʒən, kəˈlɪʒn] n. 碰撞 
colonial	[kəˈləʊniəl, kəˈloʊniəl] adj. 殖民地的;殖民地化的 n. 殖民地居民;殖民时代建筑 
colony	[ˈkɒləni, ˈkɑ:ləni] n. 殖民地 
colour	[ˈkʌlɚ, ˈkʌlə(r)] n. 颜色 vt. （用颜料、彩色笔等）为…着色 vi. 变色 
column	[ˈkɑ:ləm, ˈkɒləm] n. 专栏 
comb	[kəʊm, koʊm] n. 梳子 vt. 梳理 vi. 涌起，卷起 
combat	[ˈkɒmbæt, ˈkɑ:mbæt] n. 格斗，搏斗，战斗;〈美〉竞赛，比赛 vt. 与…战斗;与…斗争 
combination	[ˌkɑ:mbɪˈneɪʃn, ˌkɒmbɪˈneɪʃn] n. 结合 
combine	[kəmˈbaɪn] v. 使结合 
come	[kʌm] vi. 来 vt. 做 int. 嗨！ 
comedy	[ˈkɒmədi, ˈkɑ:mədi] n. 喜剧 
comfort	[ˈkʌmfət, ˈkʌmfərt] n. 舒适;安慰 vt. 安慰，使舒适;使（痛苦等）缓和 
comfortable	[ˈkʌmftəbl, ˈkʌmfətəbəl, ˈkʌmftəbəl] adj. 舒适的 
command	[kəˈmænd, kəˈmɑ:nd] n. 命令，指挥 vt. 命令 vi. 给出命令 adj. 指挥的，根据命令（或要求）而作的 
commend	[kəˈmɛnd, kəˈmend] vt. 推荐 
comment	[ˈkɒment, ˈkɑ:ment] n. 评论 vt.&vi. 评论，谈论 vt. 表达意见 vi. 作注释 
commerce	[ˈkɑ:mɜ:rs, ˈkɒmɜ:s] n. 商务 
commercial	[kəˈmɜ:ʃl, kəˈmɜ:rʃl] adj. 商业的;贸易的 n. （电台或电视播放的）广告 
commission	[kəˈmɪʃn, kəˈmɪʃən] n. 委员会，委员;[商]佣金，手续费 vt. 委任，授予;使服役 
commit	[kəˈmɪt] vt. 犯罪，做错事 
committee	[kəˈmɪti] n. 委员会 
commodity	[kəˈmɑ:dəti, kəˈmɒdəti] n. 商品 
common	[ˈkɒmən, ˈkɑ:mən] adj. 普通的;通俗的 n. 普通;[法律]（对土地、水域的）共有权 
commonwealth	[ˈkɒmənwelθ, ˈkɑ:mənwelθ] n. 联邦 
communicate	[kəˈmju:nɪkeɪt, kəˈmjunɪˌket] vt. 传达，表达;显示：清晰地揭示 vi. 通讯;交际 
communication	[kəˌmju:nɪˈkeɪʃn, kəˌmjunɪˈkeʃən] n. 交流 
communism	[ˈkɒmjunɪzəm, ˈkɑ:mjunɪzəm] n. 共产主义 
communist	[ˈkɑ:mjənɪst, ˈkɒmjənɪst] n. 共产主义者，共产主义的支持者;共产党党员 adj. 共产党的;共产主义者的 
community	[kəˈmju:nəti, kəˈmjunɪti] n. 社区 
commute	[kəˈmjut, kəˈmju:t] vi. 通勤 vt. 减刑 n. 通勤来往 
companion	[kəmˈpæniən, kəmˈpænjən] n. 同伴;[天]伴星(=~star) vt. 陪伴;同行 
company	[ˈkʌmpəni] n. 公司，商号 
comparable	[ˈkɒmpərəbl, ˈkɑ:mpərəbl] adj. 可比较的 
comparative	[kəmˈpærətɪv] adj. 比较（上）的;按比较估计的 n. [语]（形容词或副词的）比较级形式;可匹敌者，可比拟物 
compare	[kəmˈper, kəmˈpeə(r)] vt.&vi. 比较，对照 vt. 比拟，喻为 vi. 相比，匹敌 n. 比较 
comparison	[kəmˈpærɪsn, kəmˈpærɪsən] n. 比较，对照 
compartment	[kəmˈpɑ:tmənt, kəmˈpɑ:rtmənt] n. 隔间（尤指火车车厢中的）;区划 vt. 分隔;划分 
compass	[ˈkʌmpəs, ˈkʌmpəs, ˈkɑm-] n. 罗盘 
compel	[kəmˈpɛl, kəmˈpel] vt. 强迫，迫使 
compensate	[ˈkɑ:mpenseɪt, ˈkɒmpenseɪt] vt. 抵消;补偿，赔偿 vi. 补偿，弥补 
compensation	[ˌkɒmpenˈseɪʃn, ˌkɑ:mpenˈseɪʃn] n. 补偿，赔偿 
compete	[kəmˈpi:t, kəmˈpit] vi. 竞争 
competent	[ˈkɒmpɪtənt, ˈkɑ:mpɪtənt] adj. 有能力的，能胜任的 
competition	[ˌkɑ:mpəˈtɪʃn, ˌkɒmpəˈtɪʃn] n. 竞争 
competitor	[kəmˈpɛtɪtɚ, kəmˈpetɪtə(r)] n. 竞争者 
complain	[kəmˈpleɪn, kəmˈplen] vi. 抱怨，诉苦;申诉，控诉，抗议 vt. 诉说，申诉，控告[后面常跟从句] 
complaint	[kəmˈplent, kəmˈpleɪnt] n. 抱怨，控诉 
complement	[ˈkɒmplɪment, ˈkɑ:mplɪment] n. 补充;补足语 vt. 补足，补充;补助 
complete	[kəmˈpli:t, kəmˈplit] adj. 完整的;完成的 vt. 完成，使完满;完成或结束 
complex	[ˈkɒmpleks, kəmˈpleks] adj. 复杂的;难懂的 n. 情结;建筑群 
complicate	[ˈkɒmplɪkeɪt, ˈkɑ:mplɪkeɪt] vt. 使复杂化;使错综，使混乱 adj. 复杂的;麻烦的 
complicated	[ˈkɑ:mplɪkeɪtɪd, ˈkɒmplɪkeɪtɪd] adj. 结构复杂的;混乱的，麻烦的 v. 使复杂化( complicate的过去式) 
compliment	[ˈkɑ:mplɪmənt, ˈkɒmplɪmənt] n. 恭维;敬意 vt. 称赞;向…道贺 
comply	[kəmˈplaɪ] vi. 遵从 
component	[kəmˈpoʊnənt, kəmˈpəʊnənt] n. 成分;组分 adj. 成分的;组成的 
compose	[kəmˈpoʊz, kəmˈpəʊz] vt. 组成，构成 vt.&vi. 创作（乐曲、诗歌等） vi. 构图，构成 
composition	[ˌkɒmpəˈzɪʃn, ˌkɑ:mpəˈzɪʃn] n. 作文，作曲 
compound	[ˈkɒmpaʊnd, ˈkɑ:mpaʊnd] n. 复合物 
comprehend	[ˌkɒmprɪˈhend, ˌkɑ:mprɪˈhend] vt. 理解，领会 
comprehension	[ˌkɒmprɪˈhenʃn, ˌkɑ:mprɪˈhenʃn] n. 理解，理解力 
comprehensive	[ˌkɑ:mprɪˈhensɪv, ˌkɒmprɪˈhensɪv] adj. 综合的;广泛的 n. [常用复数]专业综合考试;综合学校 
compress	[kəmˈpres, kəmˈprɛs] vt. 压缩;压紧 n. 止血敷布;打包机 
comprise	[kəmˈpraɪz] vt. 包含，包括 
compromise	[ˈkɒmprəmaɪz, ˈkɑ:mprəmaɪz] n. 妥协 vi. 折中解决 vt. 违背（原则） 
compulsory	[kəmˈpʌlsəri] adj. 必修的 
compute	[kəmˈpju:t, kəmˈpjut] v. 计算，估算;推断 n. 计算 
computer	[kəmˈpju:tə(r), kəmˈpjutɚ] n. （电子）计算机，电脑 
comrade	[ˈkɒmreɪd, ˈkɑ:mræd] n. 同志 
conceal	[kənˈsil, kənˈsi:l] vt. 隐藏，隐瞒，遮住 
concentrate	[ˈkɑ:nsntreɪt, ˈkɒnsntreɪt] vt.&vi. 集中 vt. 浓缩，（使）浓缩 vi. 凝缩，浓缩，提纯 n. 浓缩物 adj. 集中起来的，经过浓缩的 
concept	[ˈkɑ:nsept, ˈkɒnsept] n. 观念，概念 
concern	[kənˈsɜ:rn, kənˈsɜ:n] vt. 涉及，关系到;使关心，使担忧 n. 关心;关系，有关 
concerning	[kənˈsɜ:nɪŋ, kənˈsɜ:rnɪŋ] prep. （表示论及）关于，就…而论 v. 涉及;“concern”的现在分词 
concert	[ˈkɑ:nsərt, ˈkɒnsət] n. 音乐会 vt. 通过双方协议来计划或安排 vi. 协调一致行动 
concession	[kənˈsɛʃən, kənˈseʃn] n. 让步，迁就 
concise	[kənˈsaɪs] adj. 简约 
conclude	[kənˈklu:d, kənˈklud] vt.&vi. 推断 vt. 缔结 vi. 终了 
conclusion	[kənˈklu:ʒn, kənˈkluʒən] n. 结论 
concrete	[ˈkɒŋkri:t, ˈkɑ:ŋkri:t] adj. 具体的，有形的，实在的，实际的 n. 混凝土 vt. 使凝固 vi. 凝固 
condemn	[kənˈdɛm, kənˈdem] vt. （通常因道义上的原因而）谴责 
condition	[kənˈdɪʃn, kənˈdɪʃən] n. 状态 vt. 制约 vt.&vi. 对…具有重要影响 
conditional	[kənˈdɪʃənl, kənˈdɪʃənəl] adj. 视…而定的;[语]条件的，假定的 n. 条件（从句），条件语 
conduct	[kənˈdʌkt,  kənˈdʌkt] vt.&vi. 传导 vt. 实施 adj. 指挥，带领，护送 vi. （在乐队里）当指挥 
conductor	[kənˈdʌktə(r), kənˈdʌktɚ] n. 售票员 
confer	[kənˈfɚ, kənˈfɜ:(r)] vt. 授予，颁与;比较，对照 vi. 商议，磋商 
conference	[ˈkɒnfərəns, ˈkɑ:nfərəns] n. 会议;讨论 vi. 举行或参加（系列）会议 
confess	[kənˈfɛs, kənˈfes] v. 承认 
confidence	[ˈkɒnfɪdəns, ˈkɑ:nfɪdəns] n. 信心;信任 adj. 骗得信任的;欺诈的 
confident	[ˈkɑ:nfɪdənt, ˈkɒnfɪdənt] adj. 确信的，深信的;有信心的，沉着的 n. 知己;心腹朋友 
confidential	[ˌkɒnfɪˈdenʃl, ˌkɑ:nfɪˈdenʃl] adj. 机密的 
confine	[kənˈfaɪn] vt. 限制;局限于 n. 界限，范围;国界 
confirm	[kənˈfɜ:m, kənˈfɜ:rm] vt. 证实 
conflict	[ˈkɒnflɪkt, ˈkɑ:nflɪkt] n. 冲突;矛盾 vi. 冲突;抵触 
conform	[kənˈfɔ:m, kənˈfɔ:rm] vi. 符合 vt. 使遵守 adj. 一致的 
confront	[kənˈfrʌnt] vt. 面对 
confuse	[kənˈfjuz, kənˈfju:z] vt. 使困窘;使混乱 vi. 使糊涂 
congratulate	[kənˈgrætʃuleɪt, kənˈɡrætʃəˌlet, -ˈɡrædʒ-, kəŋ-] vt. 祝贺 
congratulation	[kənˌgrætʃuˈleɪʃn, kənˌɡrætʃəˈleʃən, -ˌɡrædʒ-, kəŋ-] n. 贺词 
congress	[ˈkɒŋgres, ˈkɑ:ŋgrəs] n. 国会;代表大会 vi. 开会，集合 
connect	[kəˈnekt, kəˈnɛkt] vt. 连接，联结;使…有联系 vi. 连接;建立关系 
connection	[kəˈnekʃn, kəˈnɛkʃən] n. 连接 
conquer	[ˈkɒŋkə(r), ˈkɑ:ŋkə(r)] vt. 征服;克服 vi. 得胜，胜利 
conquest	[ˈkɒŋkwest, ˈkɑ:ŋkwest] n. 征服，击败 
conscience	[ˈkɒnʃəns, ˈkɑ:nʃəns] n. 良心 
conscious	[ˈkɑ:nʃəs, ˈkɒnʃəs] adj. 有意识的，神志清醒的 
consent	[kənˈsɛnt, kənˈsent] n. 同意;准许，赞同 vi. 同意;允许 
consequence	[ˈkɒnsɪkwəns, ˈkɑ:nsəkwens] n. 推论 
consequently	[ˈkɒnsɪkwəntli, ˈkɑ:nsəkwentli] adv. 所以，因此 
conservation	[ˌkɒnsəˈveɪʃn, ˌkɑ:nsərˈveɪʃn] n. 保护 
conservative	[kənˈsɜ:rvətɪv, kənˈsɜ:vətɪv] n. 保守的人;（英国）保守党党员，保守党支持者 adj. 保守的;（英国）保守党的 
consider	[kənˈsɪdə(r), kənˈsɪdər ] vt.&vi. 考虑 vt. 考虑 vi. 仔细考虑 
considerable	[kənˈsɪdərəbl,   kənˈsɪdərəbəl] adj. 相当大（或多）的 
considerate	[kənˈsɪdərət, kənˈsɪdərɪt] adj. 体贴的，体谅的 
consideration	[kənˌsɪdəˈreɪʃn, kənˌsɪdəˈreʃən] n. 考虑，考察 
consist	[kənˈsɪst] vi. 在于 
consistent	[kənˈsɪstənt] adj. 一致的 
consolidate	[kənˈsɑ:lɪdeɪt, kənˈsɒlɪdeɪt] vt. 统一;把…合成一体，合并 vi. 合并;统一 
conspicuous	[kənˈspɪkjuəs] adj. 明显的 
constant	[ˈkɒnstənt, ˈkɑ:nstənt] adj. 不断的，持续的;永恒的，始终如一的 n. [数]常数，常量;不变的事物 
constitution	[ˌkɒnstɪˈtju:ʃn, ˌkɑ:nstəˈtu:ʃn] n. 宪法 
construct	[kənˈstrʌkt] vt. 构成;修建，建造 n. 结构（物）;构想 
construction	[kənˈstrʌkʃn, kənˈstrʌkʃən] n. 建造 
consult	[kənˈsʌlt] vi. 咨询;商议，商量 vt. 请教;翻阅 
consultant	[kənˈsʌltənt] n. （受人咨询的）顾问 
consume	[kənˈsju:m, kənˈsu:m] vt. 消耗，消费 
contact	[ˈkɑ:ntækt, ˈkɒntækt] n. 接触 vt. 使接触 vi. 联系，接触 
contain	[kənˈteɪn, kənˈten] vt. 牵制 
container	[kənˈteɪnə(r), kənˈtenɚ] n. 容器 
contemporary	[kənˈtemprəri, kənˈtempəreri] adj. 当代的，现代的;同时代的，同属一个时期的 n. 同代人;同辈人 
contend	[kənˈtend, kənˈtɛnd] vi. 争夺;竞争 vt. 声称，主张;争论，争辩 
content	['kɒntent, ˈkɑ:ntent] n. 内容 
contest	[ˈkɒntest, ˈkɑ:ntest] vt. 竞争，为…而奋争;辩驳 vi. 竞争;争夺 
context	[ˈkɒntekst, ˈkɑ:ntekst] n. 语境 
continent	[ˈkɒntɪnənt, ˈkɑ:ntɪnənt] n. 欧洲大陆;大陆，陆地 adj. 自制的，克制的;节欲的 
continual	[kənˈtɪnjuəl] adj. 不间断的 
continue	[kənˈtɪnju:, kənˈtɪnju] vi. 持续;逗留 vt. 延期;使延伸 
continuous	[kənˈtɪnjuəs] adj. 连续的 
contract	[ˈkɒntrækt, ˈkɑ:ntrækt] n. 合同 
contrary	[ˈkɑ:ntreri, ˈkɒntrəri] adj. 相反的 n. 对立或相反的事物 adv. 相反地，矛盾地 
contrast	[ˈkɒntrɑ:st, ˈkɑ:ntræst] n. 对比，对照 
contribute	[kənˈtrɪbju:t, kənˈtrɪbjut] vt.&vi. 贡献出 
control	[kənˈtrəʊl, kənˈtroʊl] vt. 控制;管理 n. 支配权;操纵者 
controversial	[ˌkɑ:ntrəˈvɜ:rʃl, ˌkɒntrəˈvɜ:ʃl] adj. 有争议的，引起争议的，被争论的 
convenience	[kənˈvinjəns, kənˈvi:niəns] n. 方便，便利 
convenient	[kənˈvinjənt, kənˈvi:niənt] adj. 方便的 
convention	[kənˈvenʃn, kənˈvɛnʃən] n. 会议 
conversation	[ˌkɑ:nvərˈseɪʃn, ˌkɒnvəˈseɪʃn] n. 交谈，会话 
convict	[kənˈvɪkt] vt. 宣判有罪;证明…有罪 n. 罪犯 
conviction	[kənˈvɪkʃn, kənˈvɪkʃən] n. 定罪 
convince	[kənˈvɪns] vt. 使相信，说服，使承认 
cook	[kʊk] vt.&vi. 烹调 vt. 煮 vi. 烹调 n. 厨师 
cool	[ku:l, kul] adj. 凉爽的 vt.&vi. （使）变凉 n. 凉气，凉快的地方 
cooperate	[kəʊ'ɒpəreɪt, koˈɑpəˌret] vi. 合作，配合，协助 v. 合群;互助 
cooperation	[kəʊˌɒpəˈreɪʃn, koˌɑpəˈreʃən] n. 合作 
coordinate	[kəʊ'ɔ:dɪneɪt, ko'ɔrdəˈnet] vt. 使协调，使调和;整合 vi. 协调;协同 
cope	[koʊp, kəʊp] vi. 对抗 n. 长袍 vt. 笼罩 
copper	[ˈkɑ:pə(r), ˈkɒpə(r)] n. 铜 adj. 铜制的 vt. 镀铜 
copy	[ˈkɑ:pi, ˈkɒpi] n. 复制品 vt.&vi. 复制 vt. 复制 
core	[kɔr, kor, kɔ:(r)] n. 中心，核心，精髓;果心，果核 vt. 去（果）核，挖去…的果心;提取岩芯（样品） 
corn	[kɔ:n, kɔ:rn] n. 鸡眼 
corner	[ˈkɔ:rnə(r), ˈkɔ:nə(r)] n. 拐角 vi. 驾车转弯 vt. 垄断 adj. 位于角落的 
corporation	[ˌkɔ:rpəˈreɪʃn, ˌkɔ:pəˈreɪʃn] n. 公司 
correct	[kəˈrekt, kəˈrɛkt] adj. 正确的;合适的 v. 改正;批改 
correspond	[ˌkɒrəˈspɒnd, ˌkɔ:rəˈspɑ:nd] vi. 相应 
correspondence	[ˌkɔ:rəˈspɑ:ndəns, ˌkɒrəˈspɒndəns] n. 对应 
correspondent	[ˌkɔ:rəˈspɑ:ndənt, ˌkɒrəˈspɒndənt] n. 通讯员，记者 
corresponding	[ˌkɔ:rəˈspɑ:ndɪŋ, ˌkɒrəˈspɒndɪŋ] adj. 相当的，对应的;通信的 v. 相符合( correspond的现在分词);类似(correspond的ing形式) 
corridor	[ˈkɒrɪdɔ:(r), ˈkɔrɪdɚ, -ˌdɔr, ˈkɑr-] n. 走廊，通道 
corrupt	[kəˈrʌpt] adj. 堕落的，道德败坏的 vt. 使腐败 vi. 腐化 
cost	[kɒst, kɔ:st] n. 价钱，代价 vi. 价钱为，花费 vt. 付出代价 
costly	[ˈkɔ:stli, ˈkɒstli] adj. 昂贵的 
cottage	[ˈkɒtɪdʒ, ˈkɑ:tɪdʒ] n. 小屋，村舍 
cotton	[ˈkɑ:tn, ˈkɒtn] n. 棉;棉线 vi. 喜欢;赞成 
couch	[kaʊtʃ] n. 长沙发椅，睡椅 vt. 表达 vi. 躺卧 
cough	[kɔ:f, kɒf] vt.&vi. 咳嗽;（引擎等）发噗噗声 n. 咳，咳嗽;咳嗽病 
could	[kʊd, kəd] aux. “can”的过去式 
council	[ˈkaʊnsl, ˈkaʊnsəl] n. 委员会 
counsel	[ˈkaʊnsl, ˈkaʊnsəl] n. 建议;协商，讨论 vt. 劝告，建议;提供专业咨询 
count	[kaʊnt] n. 总数;数数 v. 数数;计算总数 
counter	[ˈkaʊntə(r), ˈkaʊntɚ] n. 计数器 adj. 相反的 vt. 反击，还击 vi. 逆向移动，对着干 adv. 反方向地 
country	[ˈkʌntri] n. 国家 
countryside	[ˈkʌntrisaɪd, ˈkʌntriˌsaɪd] n. 乡村 
county	[ˈkaʊnti] n. 县，郡 
couple	[ˈkʌpl, ˈkʌpəl] n. 对，双;配偶，夫妻 vt.&vi. 连在一起，连接;成双，结婚 
courage	[ˈkʌrɪdʒ, ˈkɜ:rɪdʒ] n. 勇气 
course	[kɔ:rs, kɔ:s] n. 课程 vt. 快速地流动 vi. 沿…（方向）前进 
court	[kɔ:rt, kɔ:t] n. 宫廷 vt. 招致 vi. 求爱，求婚 
courtyard	[ˈkɔ:rtjɑ:rd, ˈkɔ:tjɑ:d] n. 天井 
cousin	[ˈkʌzn, 'kʌzn] n. 堂[表]兄弟姊妹 
cover	[ˈkʌvə(r), ˈkʌvɚ] v. 遮盖;掩蔽 n. 封面;掩护 
cow	[kaʊ] n. 奶牛，乳牛;母兽 vt. 恐吓;吓唬 
coward	[ˈkaʊərd, ˈkaʊəd] n. 胆小鬼，懦夫 adj. 怯懦的，胆小的 
crack	[kræk] vt. 破裂，打开 vi. 断裂，折断 n. 裂缝 adj. 训练有素的 
cradle	[ˈkreɪdl, ˈkredl] n. 摇篮;发源地，发祥地 vt. 将…置于摇篮中;轻轻地抱或捧 
craft	[krɑ:ft, kræft] n. 手艺;船 vt. 手工制作;精巧地制作 
crane	[kren, kreɪn] n. 鹤 vt.&vi. 伸长，探头 vi. 迟疑，踌躇 
crash	[kræʃ] v. 碰撞 n. 崩溃 adj. 应急的 
crawl	[krɔl, krɔ:l] vi. 爬行;缓慢行进 n. 缓慢的爬行;〈美俚〉跳舞，自由式游泳 
crazy	[ˈkrezi, ˈkreɪzi] adj. 疯狂的;不理智的 n. [俚语]疯子，怪人，政治狂人（尤指政治上持激进或极端主义态度、行为异常、不可思议的人） 
cream	[kri:m, krim] n. 乳霜;精英 vt. 把…搅成糊状（或奶油状）混合物;彻底打败，狠揍 
create	[kriˈeɪt, kriˈet] vt. 产生;创造，创作 vi. [英][俚]大发脾气，大发牢骚 
creature	[ˈkritʃɚ, ˈkri:tʃə(r)] n. 人 
credit	[ˈkredɪt, ˈkrɛdɪt] n. 学分;信誉，信用 vt. 相信，信任;归功于 
creep	[krip, kri:p] vi. 爬行，匍匐;缓慢地行进 n. 爬行，蠕动;虫爬着似的感觉，毛骨悚然 
crew	[kru:, kru] n. 全体船员 vt. 当（尤指船上的）工作人员 vi. 当船员 
crime	[kraɪm] n. 罪恶;罪行，犯罪 v. 指控犯罪;判定犯罪 
criminal	[ˈkrɪmənəl, ˈkrɪmɪnl] n. 罪犯，犯人 adj. 犯罪的;刑事的 
crisis	[ˈkraɪsɪs] n. 危机 
crisp	[krɪsp] adj. 脆的 n. <英>炸马铃薯片 vt. （使）变脆 vi. 卷曲 
criterion	[kraɪˈtɪriən, kraɪˈtɪəriən] n. 规范 
critical	[ˈkrɪtɪkl, ˈkrɪtɪkəl] adj. 关键的 
criticism	[ˈkrɪtɪsɪzəm, ˈkrɪtɪˌsɪzəm] n. 批评，批判 
criticize	[ˈkrɪtɪsaɪz, ˈkrɪtɪˌsaɪz] vt.&vi. 批评 
crop	[krɑ:p, krɒp] n. 农作物 vt. 种植 vi. 收成 
cross	[krɒs, krɔ:s] n. 十字架 vi. 交错而行 vt. 杂交 adj. 坏脾气的， 易怒的 
crossing	[ˈkrɒsɪŋ, ˈkrɔ:sɪŋ] n. 人行横道，十字路口;交叉，相交 v. 交叉(cross的现在分词) 
crowd	[kraʊd] n. 人群 vi. 拥挤，聚集 vt. 挤满 
crown	[kraʊn] n. 王冠 vt. （尤指通过增添成就、成功等）使圆满 vi. 露顶 
crucial	[ˈkruʃəl, ˈkru:ʃl] adj. 决定性的 
crude	[krud, kru:d] adj. 简陋的;粗糙的，粗杂的 n. 原油;原[生]材料，天然物质 
cruel	[kru:əl, ˈkruəl] adj. 残酷的，残忍的 
crush	[krʌʃ] vt. 镇压 vi. 挤 n. 粉碎，被压碎的状态 
cry	[kraɪ] vt.&vi. 哭 vt. 哭着说 n. 哭 vi. 鸣 
crystal	[ˈkrɪstl, ˈkrɪstəl] n. 晶体;水晶 adj. 水晶的;水晶般的 
cube	[kjub, kju:b] n. 立方形，立方体;立方，三次幂 vt. 求…的立方;把（食物）切成小方块 
cucumber	[ˈkjuˌkʌmbɚ, ˈkju:kʌmbə(r)] n. 黄瓜，胡瓜 
cue	[kju:, kju] n. 线索;暗示，提示 vt. 把…插入演出;给…暗示 
cultivate	[ˈkʌltɪveɪt, ˈkʌltəˌvet] vt. 耕作，种植 
culture	[ˈkʌltʃə(r), ˈkʌltʃɚ] n. 文化;养殖 vt. 培植，培养 
cunning	[ˈkʌnɪŋ] adj. 狡猾的;灵巧的 n. 狡猾;狡黠 
cup	[kʌp] n. 杯子;一杯（的量） vt. 使（手）窝成杯状;使（双手）成圆状托起 
cupboard	[ˈkʌbəd, ˈkʌbərd] n. 橱柜 
cure	[kjʊə(r), kjʊr] vt. 治愈 vi. 受治疗 n. 治愈 
curious	[ˈkjʊəriəs, ˈkjʊriəs] adj. 好奇的 
curl	[kɜ:rl, kɜ:l] n. 一绺鬈发 vt.&vi. （使）弯曲 vt. 撅起嘴唇 
currency	[ˈkʌrənsi, ˈkɜ:rənsi] n. 货币 
current	[ˈkʌrənt, ˈkɜ:rənt] adj. 现在的;最近的 n. 电流;趋势 
curriculum	[kəˈrɪkjələm] n. 全部课程，课程 
curse	[kɜ:rs, kɜ:s] vt.&vi. 诅咒;咒骂 n. 诅咒;咒语 
curtain	[ˈkɜ:rtn, ˈkɜ:tn] n. 窗帘，门帘;帐幕之物，幕布 vt. 给（窗户或房间）装上帘子;掩蔽 
curve	[kɜ:v, kɜ:rv] n. 弧线，曲线 vt. 使弯曲 vi. 弯曲 adj. 弯曲的 
cushion	[ˈkʊʃn, ˈkʊʃən] n. 垫子;（隔离两个表面的）垫 vt. 使免遭损害;使免受令人不快的影响 
custom	[ˈkʌstəm] n. 习惯，惯例;海关，关税 adj. （衣服等）定做的，定制的 
customer	[ˈkʌstəmɚ, ˈkʌstəmə(r)] n. 顾客，客户 
cut	[kʌt] vt.&vi. 将（某物）切开（或分割） vt. 削减 vi. 电影 n. 削减 
cycle	[ˈsaɪkl, ˈsaɪkəl] n. 循环，周期 vi. 周而复始，循环 vt. 运转，循环 
dad	[dæd] n. 爸爸 
daily	[ˈdeɪli, ˈdeli] adj. 每日的，日常的 n. 日报 adv. 每日 
dairy	[ˈderi, ˈdeəri] n. 牛奶场;乳品店 adj. 乳品的;牛奶的 
dam	[dæm] n. 水库;水坝，堰 vt. 用水坝阻止;阻塞，抑制 
damage	[ˈdæmɪdʒ] vt.&vi. 损害，毁坏 n. 损害，损毁;赔偿金 
damp	[dæmp] adj. 微湿的，潮湿的 n. 潮湿 vt. 使潮湿 vi. [物]阻尼 
dance	[dɑ:ns, dæns] n. 跳舞 vi. 跳舞 vt. 使跳舞 
danger	[ˈdeɪndʒə(r), ˈdendʒɚ] n. 危险 
dangerous	[ˈdendʒərəs, ˈdeɪndʒərəs] adj. 危险的 
dare	[der, deə(r)] vt. 敢 vi. 敢 aux. 敢，竟敢 n. 激将，挑战 
dark	[dɑ:k, dɑ:rk] adj. 黑暗的;乌黑的 n. 黑暗;暗色 
darling	[ˈdɑ:rlɪŋ, ˈdɑ:lɪŋ] n. （用作称呼）亲爱的;心爱的人 adj. 倍受喜爱的，可爱的，迷人的 
dart	[dɑ:rt, dɑ:t] vt. 投掷，投射 vi. 向前冲，飞奔 n. 飞镖，标枪 
dash	[dæʃ] vi. 猛冲 vt. 猛撞 n. 短跑 
date	[deɪt, det] n. 约会 vt. 过时 vt.&vi. 与人约会，相约 vi. 属于某一特定时期 
datum	[ˈdeɪtəm, ˈdetəm, ˈdætəm, ˈdɑtəm] n. 数据，资料 
daughter	[ˈdɔ:tə(r), ˈdɔtɚ] n. 女儿;产物，后代 adj. 女儿般的;[生]第一代的 
dawn	[dɔ:n, dɔn] n. 黎明，拂晓 vi. 破晓，（天）刚亮 vt. （开始）被理解，被领悟 
day	[deɪ, de] n. 一天 adj. 日间的 adv. 每天 
daylight	[ˈdeɪlaɪt, ˈdeˌlaɪt] n. 日光，白昼 
daytime	[ˈdeɪtaɪm, ˈdeˌtaɪm] n. 昼 
dead	[dɛd, ded] adj. 死去的 adv. 完全地 n. 死者 
deadline	[ˈdɛdˌlaɪn, ˈdedlaɪn] n. 最后期限;截止期限 vt. 通过设定一时间期限来统治 
deadly	[ˈdɛdli, ˈdedli] adj. 极端的，非常的;致命的，致死的 adv. 极其，非常;死了一样地 
deaf	[def, dɛf] adj. 聋的 
deal	[di:l, dil] vt. [牌戏]分 n. （一笔）交易 vi. 交易 adj. 冷杉木制的，松木制的 
dealer	[ˈdi:lə(r), ˈdilɚ] n. 经销商 
dear	[dɪr, dɪə(r)] adj. 亲爱的 n. 亲爱的人 int. 哎 adv. 贵 
death	[dɛθ, deθ] n. 死亡 
debate	[dɪˈbeɪt,  dɪˈbet] n. 辩论;辩论 vt.&vi. 辩论;仔细考虑 
debt	[dɛt, det] n. 债务 
decade	[ˈdekeɪd, ˈdɛkˌed, dɛˈked] n. 十年，十年间 
decay	[dɪˈkeɪ, dɪˈke] vt.&vi. （使）腐烂，腐朽 vi. 衰败，衰退，衰落 n. 腐败、衰退的状态 
deceit	[dɪˈsit, dɪˈsi:t] n. 谎言 
deceive	[dɪˈsiv, dɪˈsi:v] v. 欺诈 
December	[dɪˈsɛmbɚ, dɪˈsembə(r)] n. 12月 
decide	[dɪˈsaɪd] vt. 决定;决心 vi. 决定;下决心 
decided	[dɪˈsaɪdɪd] adj. 清楚的;坚决的 v. 下决心( decide的过去式和过去分词 );（使）决定 
decimal	[ˈdesɪml, ˈdɛsəməl] adj. 十进位的，小数的 n. 小数 
decision	[dɪˈsɪʒn, dɪˈsɪʒən] n. 决定;决议 vt. [口语][拳击]靠判定击败（对手） 
deck	[dɛk, dek] n. 甲板，舱板;[建]平屋顶，桥面 vt. 装饰;给…铺上甲板 
declaration	[ˌdekləˈreɪʃn, ˌdɛkləˈreʃən] n. 宣言，布告，公告，声明 
declare	[dɪˈkleə(r), dɪˈkler] vt. 申报;宣布 vi. 宣称;声明，发表宣言 
decline	[dɪˈklaɪn] n. 下降 vt.&vi. 辞谢，谢绝（邀请等） vi. （道路、物体等）下倾 vt. 谢绝，婉拒 
decorate	[ˈdekəreɪt, ˈdɛkəˌret] vt. 装饰;点缀 vi. 装饰;布置 
decrease	[dɪˈkri:s, dɪˈkris] n. 减少，减小;减少量 vi.&vt. 减少，减小 
dedicate	[ˈdedɪkeɪt, ˈdɛdɪˌket] vt. 奉献，献身 
deduce	[dɪˈdju:s, dɪˈdu:s] vt. 演绎 
deed	[di:d, did] n. 行为;行动 v. 立契转让 
deem	[dim, di:m] vt. 认为，视为;主张，断定 vi. 认为，视为，以为;作某种评价 
deep	[di:p, dip] adj. 深的 n. 深处，深渊 adv. 深深地，深入地 
deer	[dɪr, dɪə(r)] n. 鹿 
defeat	[dɪˈfi:t, dɪˈfit] vt. 挫败;击败，战胜 n. 失败;战胜 
defect	[ˈdiˌfɛkt, dɪˈfɛkt, ˈdi:fekt] n. 瑕疵，毛病;欠缺，缺点 vi. 叛逃;背叛 
defend	[dɪˈfend, dɪˈfɛnd] vt.&vi. 保卫 
defense	[dɪ'fens, dɪˈfɛns] n. (D-)（美国）国防部，防卫，防卫物 vt. 谋划抵御 
deficit	[ˈdɛfɪsɪt, ˈdefɪsɪt] n. 赤字 
definite	[ˈdɛfənɪt, ˈdefɪnət] adj. 明确的 
degree	[dɪˈɡri, dɪˈgri:] n. 程度 
delay	[dɪˈleɪ, dɪˈle] n. 耽搁 vt. 耽搁 vi. 延缓，延期 
delegation	[ˌdelɪˈgeɪʃn, ˌdɛlɪˈɡeʃən] n. 授权 
delicious	[dɪˈlɪʃəs] adj. 美味的，可口的 
delight	[dɪˈlaɪt] n. 快乐，高兴 vt. 使高兴，使欣喜 vi. 感到高兴[快乐] 
deliver	[dɪˈlɪvə(r), dɪˈlɪvɚ] vt. 交付;发表 vi. 传送;投递 
demand	[dɪˈmænd, dɪˈmɑ:nd] vt. 需要 n. 需求 vi. 需要 
democracy	[dɪˈmɒkrəsi, dɪˈmɑ:krəsi] n. 民主政治 
democratic	[ˌdɛməˈkrætɪk, ˌdeməˈkrætɪk] adj. 民主的 
demonstrate	[ˈdɛmənˌstret, ˈdemənstreɪt] vt. 论证;证明，证实 vi. 示威游行 
denial	[dɪˈnaɪəl] n. 克制 
dense	[dens, dɛns] adj. 密集的，稠密的 
density	[ˈdensəti, ˈdɛnsɪti] n. 密度 
dentist	[ˈdɛntɪst, ˈdentɪst] n. 牙科医生 
deny	[dɪˈnaɪ] vt. 拒绝 
depart	[dɪˈpɑ:t, dɪˈpɑ:rt] v. 离开，出发 
department	[dɪˈpɑ:rtmənt, dɪˈpɑ:tmənt] n. 部门，部 
departure	[dɪˈpɑ:tʃə(r), dɪˈpɑ:rtʃə(r)] n. 背离 
depend	[dɪˈpɛnd, dɪˈpend] vi. 依赖 
deposit	[dɪˈpɒzɪt, dɪˈpɑ:zɪt] n. 保证金 vt.&vi. 储蓄 vi. 沉淀 
depth	[dɛpθ, depθ] n. 深度 
deputy	[ˈdɛpjəti, ˈdepjuti] n. 代表;副手 adj. 副的;代理的 
derive	[dɪˈraɪv] vt.&vi. 得到，导出 
descend	[dɪˈsɛnd, dɪˈsend] v. 降临 
describe	[dɪˈskraɪb] vt. 叙述 
description	[dɪˈskrɪpʃn, dɪˈskrɪpʃən] n. 描述 
desert	[ˈdezət, ˈdezərt] n. 沙漠;荒地 adj. 沙漠的;荒芜的，不毛的 
deserve	[dɪˈzɜ:v, dɪˈzɜ:rv] vt. 值得;应得 vi. 应受报答;应得报酬 
design	[dɪˈzaɪn] vt.&vi. 设计 vt. 设计 n. 设计 vi. 设计略图 
desirable	[dɪˈzaɪrəbəl, dɪˈzaɪərəbl] adj. 可取的;令人满意的 n. 称心如意的人[东西] 
desire	[dɪˈzaɪə(r),  dɪˈzaɪr] vt. 渴望 n. 欲望 vi. 愿望 
desk	[dɛsk, desk] n. 书桌，办公桌;服务台 adj. 书桌的，书桌上用的 
despair	[dɪˈspeə(r), dɪˈsper] n. 绝望;使人绝望的人（或事物） vi. 绝望 
desperate	[ˈdespərət, ˈdɛspərɪt] adj. 绝望的 
despise	[dɪˈspaɪz] vt. 鄙视，看不起 
despite	[dɪˈspaɪt] prep. 不管;虽有 n. 侮辱;憎恨 
dessert	[dɪˈzɜ:t, dɪˈzɜ:rt] n. 甜点 
destination	[ˌdestɪˈneɪʃn, ˌdɛstəˈneʃən] n. 目的，目标 
destiny	[ˈdɛstəni, ˈdestəni] n. 命运 
destroy	[dɪˈstrɔɪ] vt. 杀死 
destruction	[dɪˈstrʌkʃən, dɪˈstrʌkʃn] n. 摧毁 
detach	[dɪˈtætʃ] vt. 派遣 
detail	[ˈdi:teɪl, dɪˈteɪl] n. 详述;（照片、绘画等的）细部 vt. 详述，仔细汇报;选派 
detain	[dɪˈten, dɪˈteɪn] vt. 耽搁 
detective	[dɪˈtektɪv, dɪˈtɛktɪv] adj. 侦探的;适于探测的 n. 侦探 
determine	[dɪˈtɜ:mɪn, dɪˈtɜ:rmɪn] vt.&vi. （使）下决心，（使）做出决定 vt. 决定，确定 vi. [主用于法律]了结，终止，结束 
develop	[dɪˈvɛləp, dɪˈveləp] vi. 发展;形成 vt. 发展;开发 
development	[dɪˈveləpmənt, dɪˈvɛləpmənt] n. 发展，进化 
device	[dɪˈvaɪs] n. 装置，设备 
devise	[dɪˈvaɪz] v. 设计;想出 n. 遗赠;遗赠的财产 
devote	[dɪˈvəʊt, dɪˈvoʊt] vt. 奉献 
dew	[dju:, du:] n. 水珠，露水 vt. 弄湿 
diagram	[ˈdaɪəgræm, ˈdaɪəˌɡræm] n. 图表;示意图 vt. 图解;用图表示 
dial	[ˈdaɪəl] n. 表盘 vt.&vi. 打电话，拨电话号码 vt. 用标度盘测量 
dialogue	['daɪəlɒɡ, ˈdaɪəˌlɔɡ, -ˌlɑɡ] n. 对话 vt. 用对话表达 vi. 对话 
diameter	[daɪˈæmɪtɚ, daɪˈæmɪtə(r)] n. 直径，直径长 
diamond	[ˈdaɪəmənd, ˈdaɪmənd, ˈdaɪəmənd] n. 菱形 vt. 镶钻石于 adj. 金刚石的 
diary	[ˈdaɪəri] n. 日记，日志 
dictate	[dɪkˈteɪt, ˈdɪkteɪt] vt. 口述;命令，指示 vi. 口述;命令 
dictation	[dɪkˈteɪʃn, dɪkˈteʃən] n. 命令 
dictator	[dɪkˈteɪtə(r), ˈdɪkteɪtər] n. 独裁者 
dictionary	[ˈdɪkʃənri, ˈdɪkʃəneri] n. 词典，字典 
die	[daɪ] vt.&vi. 死亡，熄灭;凋零，枯萎 n. 钢型，硬模;骰子 
diet	[ˈdaɪət, ˈdaɪɪt] n. 日常饮食 vt.&vi. （使）节制饮食 vi. 节食 
differ	[ˈdɪfə(r), ˈdɪfɚ] vi. 不同，相异 
difference	[ˈdɪfrəns, ˈdɪfərəns, ˈdɪfrəns] n. 差别，差异;[数]差数，差额 vt. 辨别，区分 
different	[ˈdɪfrənt] adj. 不同的 
difficult	[ˈdɪfɪˌkʌlt, -kəlt, ˈdɪfɪkəlt] adj. 困难的 
difficulty	[ˈdɪfɪkəlti, ˈdɪfɪˌkʌlti, -kəl-] n. 难度 
dig	[dɪg, dɪɡ] vt. （如用铲、锨或推土机等）挖掘 vi. 挖掘，松土 n. 一拳，一推 
digest	[daɪˈdʒest] vt.&vi. 消化 vt. 吸收 vi. 消化 n. 文摘 
digital	[ˈdɪdʒɪtl] adj. 数字的;数据的 n. 数字;手指 
dignity	[ˈdɪgnəti] n. 尊严 
diligent	[ˈdɪlɪdʒənt, ˈdɪlədʒənt] adj. 勤奋的 
dim	[dɪm] adj. 暗淡的，昏暗的 vt.&vi. （使）变暗淡 n. 笨蛋，傻子 
dine	[daɪn] vi. 吃饭，进餐 vt. 设宴款待，请客 
dining-room	[ ˈdaɪnɪŋˌrum, 'daɪnɪŋ rʊm] n. 餐厅 
dinner	[ˈdɪnə(r), ˈdɪnɚ] n. 晚餐 
dip	[dɪp] vt. 浸 vt.&vi. （使）微降，（使）下沉 n. 倾斜 vi. 浸水 
diploma	[dɪˈpləʊmə, dɪˈploʊmə] n. 毕业文凭;学位证书 v. 发毕业文凭 
diplomatic	[ˌdɪpləˈmætɪk] adj. 外交上的 
direct	[dəˈrekt, dɪˈrɛkt, daɪ-] adj. 直接的 adv. 直接地 vt. （用建议、指示、有益的情报等）指导 vt.&vi. 指导，导演，管理 vi. 引路 
direction	[dɪˈrɛkʃən, daɪ-, dəˈrekʃn] n. 方向 
directly	[dəˈrektli, dɪˈrɛktli, daɪ-] adv. 直接地;不久，立即 conj. 一…就… 
director	[dɪˈrɛktɚ, daɪ-, dəˈrektə(r)] n. 导演 
dirty	[ˈdɜ:ti, ˈdɜ:rti] adj. 肮脏的 vt. 弄脏，污染 vi. 变脏，污染 
disadvantage	[ˌdɪsədˈvɑ:ntɪdʒ, ˌdɪsədˈvæntɪdʒ] n. 不利，劣势，短处 
disagree	[ˌdɪsəˈgri:, ˌdɪsəˈɡri] vi. 不同意 
disappear	[ˌdɪsəˈpɪə(r), ˌdɪsəˈpɪr] vi. 不见，消失 
disappoint	[ˌdɪsəˈpɔɪnt] vt. 使失望;使破灭，使落空 vi. 使失望 
disaster	[dɪˈzæstə(r), dɪˈzɑ:stə(r)] n. 灾难 
disc	[dɪsk] n. 圆盘 
discard	[dɪsˈkɑ:rd, dɪsˈkɑ:d] vt. 丢弃，抛弃 n. 被抛弃的人[物] vi. 出无用的牌 
discharge	[dɪsˈtʃɑ:dʒ, dɪsˈtʃɑ:rdʒ] vt. 下（客） vt.&vi. 放出 n. （气体、液体如水从管子里）流出 vi. （船、飞机等）卸货 
discipline	[ˈdɪsəplɪn] vt. 训练;使有纪律 n. 纪律;学科 
discount	[ˈdɪskaʊnt, ˈdɪsˌkaʊnt] vt. 打折扣，减价出售 vi. 折扣 n. 贴现 
discover	[dɪˈskʌvə(r), dɪˈskʌvɚ] vt. 发现 
discovery	[dɪˈskʌvəri] n. 发现，发觉 
discuss	[dɪˈskʌs] vt. 商量 
discussion	[dɪˈskʌʃn, dɪˈskʌʃən] n. 讨论，谈论 
disease	[dɪˈzi:z, dɪˈziz] n. 疾病;弊端 vt. 传染;使…有病 
disguise	[dɪsˈgaɪz, dɪsˈɡaɪz] vt. 掩盖;化装 n. 伪装;伪装品 
disgust	[dɪsˈgʌst, dɪsˈɡʌst] n. 反感，厌恶，嫌恶 vt. 使反感，厌恶 
dish	[dɪʃ] n. 盘 vt. 盛于碟盘中 vi. 成碟状 
dislike	[dɪsˈlaɪk] vt. 厌恶;不喜欢 n. 讨厌;厌憎 
dismay	[dɪsˈmeɪ, dɪsˈme] vt. 使惊愕，使焦虑，使气馁 n. 惊愕，气馁 
dismiss	[dɪsˈmɪs] vt. 解雇，把…免职;遣散，解散（队伍等） vi. 解散 
disorder	[dɪsˈɔ:də(r), dɪsˈɔ:rdə(r)] n. 混乱，凌乱;动乱，骚乱 vt. 使混乱，使凌乱;扰乱 
dispatch	[dɪˈspætʃ] vt. 派遣，调度;（迅速地）发出 n. （使者等的）派遣;急件 
displace	[dɪsˈpleɪs, dɪsˈples] vt. 移动，移走 
display	[dɪˈsple, dɪˈspleɪ] n. 显示器 vt. 显示 vi. （计算机屏幕上）显示 
displease	[dɪsˈpli:z, dɪsˈpliz] vt. 使生气，使不愉快;冒犯，触怒 vi. 使生气;使不快 
dispose	[dɪˈspoʊz, dɪˈspəʊz] vt.&vi. 处理，处置;安排 vt. 布置;排列 
dispute	[dɪˈspju:t, dɪˈspjut] vt.&vi. 辩论，争论 vt. 就…进行争论，辩论 n. 争端 vi. 争执 
distance	[ˈdɪstəns] n. 远处;距离，路程 vt. 把…远远甩在后面;疏远 
distant	[ˈdɪstənt] adj. 遥远的 
distinct	[dɪˈstɪŋkt] adj. 明显的，清楚的 
distinction	[dɪˈstɪŋkʃən, dɪˈstɪŋkʃn] n. 区别 
distinguish	[dɪˈstɪŋgwɪʃ, dɪˈstɪŋɡwɪʃ] vi. 区分，辨别，分清;辨别是非 vt. 区分，辨别，分清;辨别出，识别 
distress	[dɪˈstrɛs, dɪˈstres] n. 悲痛;危难，不幸 vt. 使痛苦，使忧伤;[法]扣押（财物） 
distribute	[dɪˈstrɪbju:t, dɪˈstrɪbjut] vt. 分配，散布 
district	[ˈdɪstrɪkt] n. 地区;教区 vt. 把…分区 
disturb	[dɪˈstɜ:b, dɪˈstɜ:rb] vt. 打扰，妨碍 
ditch	[dɪtʃ] n. 沟渠 vt. 摆脱，抛弃 vi. 使（飞机）在海上紧急降落，（在海上）迫降 
dive	[daɪv] vi. 潜水 n. 潜水 vt.&vi. 突然下降，暴跌 
diverse	[daɪˈvɜ:s, daɪˈvɜ:rs] adj. 不同的，多种多样的 
divide	[dɪˈvaɪd] vt.&vi. 分;划分 n. 分配;分水岭，分界线 
division	[dɪˈvɪʒn, dɪˈvɪʒən] n. 部门 
divorce	[dɪ'vɔ:s, dɪˈvɔ:rs] n. 离婚 vt. 与…离婚 vt.&vi. 与（某人）离婚，判（某人）离婚 
do	[du] aux. 构成疑问句和否定句 vt. 做 vi. 表现 n. 社交聚会 
dock	[dɒk, dɑ:k] n. 码头 vt.&vi. （使）船停靠码头 vi. 入船坞 
doctor	[ˈdɒktə(r), ˈdɑ:ktə(r)] n. 博士 vt.&vi. 医疗，行医 vt. 修理，装配 
doctrine	[ˈdɑ:ktrɪn, ˈdɒktrɪn] n. 教条，教义 
document	[ˈdɒkjumənt, ˈdɑ:kjumənt] n. 公文;（计算机）文档，证件 vt. 记录;证明 
dog	[dɒg, dɔ:g] n. 狗;蹩脚货 v. 困扰;跟踪 
doll	[dɑ:l, dɒl] n. 玩偶;（口技演员使用的）木偶 vt. 把…打扮漂亮 
dollar	[ˈdɒlə(r), ˈdɑ:lə(r)] n. 美元 
domain	[doʊˈmeɪn, dəˈmeɪn] n. 范围，领域 
dome	[doʊm, dəʊm] n. 圆屋顶 vt. 加圆屋顶于…上 vi. 成圆顶状 
domestic	[dəˈmestɪk, dəˈmɛstɪk] adj. 国内的;家庭的，家的 n. 佣人;国货 
donate	[dəʊˈneɪt, ˈdoʊneɪt] vt.&vi. （尤指向慈善机构）捐赠;献（血） n. 捐赠;捐献 
donkey	[ˈdɒŋki, ˈdɑ:ŋki] n. 驴，毛驴 
door	[dɔr,dor, dɔ:(r)] n. 门，户 
dorm	[dɔ:rm, dɔ:m] n. 宿舍 
dose	[dəʊs, doʊs] n. 剂量，药量 vi. 服药 vt. 给药 
dot	[dɑ:t, dɒt] n. 点，小圆点 vt. 点缀;打点于 
double	[ˈdʌbəl, ˈdʌbl] adj. 双的 vt. 使加倍 vi. 加倍，加倍努力 adv. 两倍地 n. 两倍 
doubt	[daʊt] n. 怀疑，疑虑 vt. 怀疑，疑惑 vi. 不确定，不能肯定或怀疑 
doubtful	[ˈdaʊtfl, ˈdaʊtfəl] adj. 难以预测的 
dove	[dʌv] n. 鸽;纯洁的人，天真无邪的人 v. 潜水( dive的过去式) 
down	[daʊn] adv. 向下 prep. （从高处）向下 adj. 向下的 n. （鸟的）绒羽 vt. 放下 vi. 下来 
downstairs	[ˌdaʊnˈsterz, ˌdaʊnˈsteəz] adv. 在楼下;向[往]楼下 adj. 楼下的 
downtown	[ˌdaʊnˈtaʊn, ˈdaʊnˌtaʊn] n. 市中心区 adj. 商业区的，闹市区的 adv. 在商业（闹市）区 
downward	[ˈdaʊnwəd, ˈdaʊnwərd] adj. 向下的，往下的 adv. 向下地，下行地 
doze	[doʊz, dəʊz] vi. 假寐 vt. 打瞌睡度过 n. 瞌睡 
dozen	[ˈdʌzn, ˈdʌzən] n. （一）打，十二个 adj. 一打的 
draft	[drɑ:ft, dræft] n. 汇票 vt. 起草 vi. 拟稿 adj. 初步画出或（写出）的 
dragon	[ˈdrægən, ˈdræɡən] n. 龙，龙船 
drain	[dren, dreɪn] vi. 排水 vt. 喝光，喝干 n. 排水 
drama	[ˈdrɑ:mə, ˈdrɑmə, ˈdræmə] n. 戏剧，剧本 
dramatic	[drəˈmætɪk] adj. 引人注目的 
draw	[drɔ:, drɔ] vt.&vi. 吸引 vt. 画 vi. 汲取 n. 抽奖 
drawer	[ˈdrɔɚ, drɔ:(r)] n. 抽屉 
drawing	[ˈdrɔ:ɪŋ, ˈdrɔɪŋ] n. 绘画;制图 v. 拉;绘画(draw的现在分词) 
dread	[drɛd, dred] vt. 害怕，担心 n. 恐惧，畏惧 adj. 可怕的 vi. 十分害怕 
dreadful	[ˈdredfl, ˈdrɛdfəl] adj. 可怕的;糟糕的 n. <英>惊险小说[杂志] 
dream	[dri:m, drim] vi. 梦想 vt.&vi. 做梦，向往 vt. 梦想 n. 梦想 adj. 梦的 
dress	[drɛs, dres] n. 衣服 vt.&vi. 打扮 adj. 连衣裙的 vt. 给…穿衣 vi. 穿衣 
drift	[drɪft] vi. 漂泊 vt. 漂流 n. 漂移，偏移 
drill	[drɪl] n. 钻头 vt.&vi. 训练 vt. 作…演习，操练 
drink	[drɪŋk] vt.&vi. 喝酒 vt. 吸收，吸入 n. 酒，饮料 
drip	[drɪp] vt.&vi. （使）滴下 vi. 滴出 n. 水滴 
drive	[draɪv] v. 驱动;开车 n. 驱动器;驱车旅行 
driver	[ˈdraɪvə(r), ˈdraɪvɚ] n. 驾驶员，司机 
drop	[drɑ:p, drɒp] vt.&vi. （使）落下 vt. 放弃 n. 滴 vi. （水或其他液体）滴 
drown	[draʊn] vt. 淹死;浸没 vi. 淹死 
drug	[drʌɡ, drʌg] n. 药物 vt. （在食物或饮料中）投放麻醉药，下麻醉药 vi. 使服麻醉药，用药麻醉，使服兴奋剂 
drum	[drʌm] n. 鼓 vt. 击鼓 vi. 击鼓 
drunk	[drʌŋk] adj. 醉的 n. 醉汉，酒鬼，酗酒者 v. 喝（酒）( drink的过去分词) 
dry	[draɪ] adj. 干的干燥的，干旱的 vt. 从…去掉水分，使…变干 vi. 变干 n. 干涸 
duck	[dʌk] n. 鸭肉;鸭子，野鸭 vt.&vi. 躲避，回避;潜入 
due	[dju:, du:] adj. 由于 n. 应有的权利 adv. 正向 
dull	[dʌl] adj. 迟钝的;钝的 v. 缓和;减轻 
dumb	[dʌm] adj. 哑的，无说话能力的 
during	[ˈdʊrɪŋ, ˈdjʊərɪŋ] prep. 在…的时候 
dusk	[dʌsk] n. 黄昏，傍晚 adj. 微暗的 v. 变暗 
dust	[dʌst] n. 灰尘 vt.&vi. 拂（一拂），掸（一掸） vt. 撒（粉）于 
dusty	[ˈdʌsti] adj. 布满灰尘的 
duty	[ˈdju:ti, ˈdu:ti] n. 义务 
dwell	[dwel, dwɛl] vi. 居住 
dye	[daɪ] n. 染料，染色 vt. 染色 vi. 染上或粘上（颜色） 
dying	[ˈdaɪɪŋ] adj. <口>渴望，切盼;垂死的，临终的 v. “die”的现在分词 
dynasty	[ˈdɪnəsti, ˈdaɪnəsti] n. 王朝 
e.g.	[, ˌi: ˈdʒi:] abbr. <外>(=exempli gratia)例如 adv. 举例来说（等于for example） 
each	[i:tʃ, itʃ] adj. 每;各自的 pron. 每个;各自 
eager	[ˈi:gə(r), ˈiɡɚ] adj. 急切 
eagle	[ˈi:gl, ˈiɡəl] n. 鹰;鹰状标志 v. [高]低于标准杆数两杆 
ear	[ɪr, ɪə(r)] n. 耳朵;穗 vi. 抽穗;（美俚）听见 
early	[ˈɜ:li, ˈɜ:rli] adj. 早期的;早的 adv. 早;提早 
earn	[ɜ:n, ɜ:rn] vt.&vi. 赢得;获得 vt. 获得;挣得 
earnest	[ˈɜ:rnɪst, ˈɜ:nɪst] adj. 热心的;诚挚的，真挚的 n. 认真;诚挚 
earth	[ɜ:θ, ɜ:rθ] n. 地球 vt. 把（电线）接地 vi. 躲进地洞 
earthquake	[ˈɜ:θkweɪk, ˈɜ:rθkweɪk] n. 地震 
ease	[i:z, iz] n. 安逸 vt. 减轻 vi. 缓解，减少 
easily	[ˈi:zəli, ˈizəli] adv. 容易地 
east	[i:st] n. 东，东方 adj. 东方的，向东方的 adv. 向东方（地） 
Easter	[ˈistɚ, ˈi:stə(r)] n. <宗>复活节 
eastern	[ˈi:stərn, ˈi:stən] adj. 东方的，东部（地方）的;朝东的 n. 东方人;（美国）东部地区的人 
eastward	[ˈistwəd, 'i:stwəd] adj. 朝东的 adv. 向东 n. 东方，东部 
easy	[ˈizi, ˈi:zi] adj. 容易的 adv. 容易地 vi. 停止划桨（常用作命令） vt. 向（水手或划手）发出停划命令 
eat	[i:t] vt.&vi. 吃，喝 vi. （食物）吃起来感到 vt. （如酸）腐蚀 
echo	[ˈekoʊ, ˈekəʊ] n. 回声，共鸣 vt. 重复，效仿 vi. 被重复 
economic	[ˌi:kəˈnɒmɪk, ˌi:kəˈnɑ:mɪk] adj. 经济的 
economical	[ˌi:kəˈnɒmɪkl, ˌi:kəˈnɑ:mɪkl] adj. 经济的 
economics	[ˌi:kəˈnɒmɪks, ˌi:kəˈnɑ:mɪks] n. 经济学 
economy	[ɪˈkɑ:nəmi, ɪˈkɒnəmi] n. 经济 
edge	[ɛdʒ, edʒ] n. 边 vt. 在…上加边界 vi. 慢慢向前移动，侧身移动 
edit	[ˈedɪt, ˈɛdɪt] vt. 编辑;剪辑（影片，录音） n. 编辑 
edition	[ɪˈdɪʃn, ɪˈdɪʃən] n. 版次，版本 
editor	[ˈedɪtə(r), ˈɛdɪtɚ] n. 编辑，编者 
editorial	[ˌɛdɪˈtɔriəl, -ˈtor-, ˌedɪˈtɔ:riəl] adj. 编辑的，主笔的;〈美〉社论的 n. 社论（美） 
educate	[ˈedʒukeɪt, ˈɛdʒəˌket] vt.&vi. 教育，教导;训练，培养 vt. 使理解或接受 
education	[ˌedʒuˈkeɪʃn, ˌɛdʒəˈkeʃən] n. 教育 
effect	[ɪˈfekt, ɪˈfɛkt] n. 效果;影响 vt. 使发生;引起 
effective	[ɪˈfektɪv, ɪˈfɛktɪv] adj. 有效的;起作用的 n. [军]现役兵额，有生力量，精兵 
effort	[ˈefət, ˈefərt] n. 工作 
egg	[eg, ɛɡ] n. 卵;鸡蛋，蛋 vt. 煽动，怂恿;用蛋烹调 
eight	[eɪt, et] num. 八 n. 八 adj. 八个的 
eighteen	[ˌeɪˈti:n, eˈtin] num. 十八;十八个 n. 十八岁;十八的记号 
eighth	[eɪtθ, etθ, eθ] num. 八分之一 adv. 第八 n. 八分之一 
eighty	[ˈeɪti, ˈeti] num. 八十 n. 八十 adj. 八十的 
either	[ˈiðɚ, ˈaɪðɚ, ˈaɪðə(r)] pron. （两者之中）任何一个 adj. （两者中）任一的 adv. （否定句中）也 conj. [通常用于“either…or…”结构中]或者，要么[在“either…or…”结构中，动词的人称和数一般与离得最近的主动响应，但有时用第三人称单数，在口语中也有把两个主语合在一起用作复数的] 
elbow	[ˈelbəʊ, ˈelboʊ] n. 肘部 vt. 用肘推挤（另一人或另一些人） vi. 用肘推搡着前进 
elder	[ˈɛldɚ, ˈeldə(r)] n. 长者;长辈 adj. 年纪较大的;资格老的 
eldest	[ˈeldɪst, ˈɛldɪst] adj. 最年长的，最老的;年事最高的(old的最高级) n. 最年长者 
elect	[ɪˈlɛkt, ɪˈlekt] vt. 选举 vi. 选择，挑选 adj. 精选的，选出的 n. 被选的人 
election	[ɪˈlekʃn, ɪˈlɛkʃən] n. 选举，当选 
electric	[ɪˈlektrɪk, ɪˈlɛktrɪk] adj. 电动的;电的，带电的 n. 电动车辆;带电体 
electricity	[ɪlɛkˈtrɪsɪti,ˌilɛk-, ɪˌlekˈtrɪsəti] n. 电力 
elegant	[ˈelɪgənt, ˈɛlɪɡənt] adj. （人或其举止）优美的 
element	[ˈelɪmənt, ˈɛləmənt] n. 要素 
elementary	[ˌelɪˈmentri, ˌɛləˈmɛntəri, -tri] adj. 初等 
elephant	[ˈelɪfənt, ˈɛləfənt] n. 象，大象 
elevator	[ˈɛləˌvetɚ, ˈelɪveɪtə(r)] n. 电梯 
eleven	[ɪˈlevn, ɪˈlɛvən] num. 十一 n. 十一 adj. 十一的 
eleventh	[ɪˈlɛvənθ, ɪ'levnθ] num. 第十一;十一分之一的 n. 第十一;（每月的）第十一日 
else	[els, ɛls] adv. 其他;否则 adj. 别的;其他的 
elsewhere	[ˌelsˈwer, ˌelsˈweə(r)] adv. 在别处，到别处 
embarrass	[ɪmˈbærəs, ɛmˈbærəs] vt.&vi. （使）窘迫，（使）局促不安 
embassy	[ˈembəsi, ˈɛmbəsi] n. 大使馆 
embrace	[ɛmˈbres, ɪmˈbreɪs] vt.&vi. 拥抱 vt. 接受 n. 拥抱，怀抱 
emerge	[iˈmɜ:dʒ, iˈmɜ:rdʒ] vi. 出现，浮现 
emergency	[iˈmɜ:rdʒənsi, iˈmɜ:dʒənsi] n. 紧急情况;突发事件 adj. 紧急的，应急的 
emigrate	[ˈemɪgreɪt, ˈɛmɪˌɡret] vt. 移居国外 
emotion	[ɪˈmoʊʃn, ɪˈməʊʃn] n. 情绪 
emperor	[ˈɛmpəɚ, ˈempərə(r)] n. 皇帝，君主 
emphasis	[ˈɛmfəsɪs, ˈemfəsɪs] n. 强调 
emphasize	[ˈemfəsaɪz, ˈɛmfəˌsaɪz] vt. 强调，着重 
empire	[ˈempaɪə(r), ˈɛmˌpaɪr] n. 帝国，帝国领土;帝权，君权，最高统治权 adj. 新古典风格的 
employ	[ɪmˈplɔɪ, ɛmˈplɔɪ] vt. 雇用;使用，利用 n. 受雇;服务 
employee	[ɪmˈplɔɪi:] n. 雇工，雇员，职工 
employer	[ɪmˈplɔɪə(r), ɪmˈplɔɪər] n. 雇主，老板 
employment	[ɪmˈplɔɪmənt, ɛmˈplɔɪmənt] n. 雇用 
empty	[ˈɛmpti, ˈempti] adj. 空的，空虚的，空洞的 vt. （使）成为空的， 把…弄空 vi. 成为空的 n. 空车 
enable	[ɛˈnebəl, ɪˈneɪbl] vt. 使能够，提供做…的权利[措施] 
encounter	[ɪnˈkaʊntə(r), ɛnˈkaʊntɚ] vt. 遭遇 n. 相遇，碰见 vi. 碰见，尤指不期而遇 
encourage	[ɪnˈkɜ:rɪdʒ, ɪnˈkʌrɪdʒ] vt. 促进 
end	[ɛnd, end] n. 端;<正>结果 vt.&vi. 结束，终止 
endeavour	[ɪn'devə(r), ɛnˈdɛvɚ] n. 尽力，竭力 vi.&vt. 努力，竭力 
ending	[ˈendɪŋ, ˈɛndɪŋ] n. 结束;结局 v. 结束，终止(end的现在分词) 
endure	[ɪnˈdʊr, ɪnˈdjʊə(r)] vt. 忍耐;容忍 vi. 忍耐;持续，持久 
enemy	[ˈenəmi, ˈɛnəmi] n. 敌军;仇敌 adj. 敌人的;敌方的 
energetic	[ˌenəˈdʒetɪk, ˌenərˈdʒetɪk] adj. 精力充沛的，充满活力的 
energy	[ˈenədʒi, ˈenərdʒi] n. 精力 
enforce	[ɪnˈfɔ:rs, ɪnˈfɔ:s] vt. 加强 
engage	[ɪn'gedʒ, ɪnˈgeɪdʒ] vt. 聘用;吸引住 vi. 从事;与…建立密切关系 
engine	[ˈendʒɪn, ˈɛndʒɪn] n. 发动机，引擎;工具 vt. 给…安装发动机 
engineer	[ˌendʒɪˈnɪə(r), ˌendʒɪˈnɪr] n. 工程师，技师;（轮船的）机师 vt. 设计，策划;安排或处理 
engineering	[ˌendʒɪˈnɪrɪŋ, ˌendʒɪˈnɪərɪŋ] n. 工程（学）， 工程师行业 
England	['ɪŋɡlənd, ˈɪŋɡlənd] n. 英格兰 
English	[ˈɪŋglɪʃ, ˈɪŋɡlɪʃ] n. 英语 adj. 英语的;英国的 
Englishman	[ˈɪŋglɪʃmən, ˈɪŋɡlɪʃmən] n. 英吉利人 
enjoy	[ɪnˈdʒɔɪ, ɛnˈdʒɔɪ] vt. 喜欢;欣赏 vi. 使过得快活 
enjoyment	[ɪnˈdʒɔɪmənt, ɛnˈdʒɔɪmənt] n. 享受 
enlarge	[ɪnˈlɑ:dʒ, ɪnˈlɑ:rdʒ] vt.&vi. 扩大，放大 
enlighten	[ɛnˈlaɪtn, ɪnˈlaɪtn] vt. 启发，启蒙 
enormous	[ɪˈnɔ:məs, ɪˈnɔ:rməs] adj. 巨大的 
enough	[ɪˈnʌf] adv. 足够地，充足地 adj. 足够的 n. 充分，足够 int. 够了 
enrich	[ɛnˈrɪtʃ, ɪnˈrɪtʃ] vt. 使富裕，使富有 
ensure	[ɪn'ʃʊə(r), ɛnˈʃʊr] vt. 确保 
enter	[ˈɛntɚ, ˈentə(r)] vt.&vi. 进入 
enterprise	[ˈentəpraɪz, ˈentərpraɪz] n. 企（事）业单位 
entertainment	[ˌentərˈteɪnmənt, ˌentəˈteɪnmənt] n. 娱乐节目 
enthusiasm	[ɪnˈθju:ziæzəm, ɪnˈθu:ziæzəm] n. 热情，热忱 
enthusiastic	[ɪnˌθju:ziˈæstɪk, ɪnˌθu:ziˈæstɪk] adj. 热情的 
entire	[ɪnˈtaɪə(r), ɛnˈtaɪr] adj. 整个的 
entrance	[ˈentrəns] n. 进入;入口，进口 vt. 使出神，使入迷;使喜悦，使狂喜 
entry	[ˈentri, ˈɛntri] n. 进入，入场 
envelope	[ˈenvəloʊp, ˈenvələʊp] n. 信封，封皮 
environment	[ɛnˈvaɪrənmənt, -ˈvaɪən-, ɪnˈvaɪrənmənt] n. 环境，外界 
envy	[ˈenvi, ˈɛnvi] n. 羡慕;嫉妒，妒忌 vi. 感到妒忌;显示出妒忌 
equal	[ˈikwəl, ˈi:kwəl] adj. 相等的，平等的 vt. 等于 n. 同样的人 vi. 相等，相平（与out连用） 
equator	[ɪˈkwetɚ, ɪˈkweɪtə(r)] n. 赤道 
equipment	[ɪˈkwɪpmənt] n. 设备，装备 
equivalent	[ɪˈkwɪvələnt] adj. 相等的，相当的，等效的;等价的，等积的 n. 对等物;[化学]当量 
era	[ˈɪərə, ˈɪrə] n. 纪元，年代 
erase	[ɪˈreɪz, ɪˈreɪs] vt. 抹去 
erect	[ɪˈrɛkt, ɪˈrekt] vt. 使直立，使竖起;建立，创立 adj. 直立的，垂直的;（头、手等）朝上举的 
error	[ˈerə(r), ˈɛrɚ] n. 错误，过失 
erupt	[ɪˈrʌpt] vi. 爆发;喷发 vt. 爆发 
escape	[ɪˈskeɪp, ɪˈskep] v. 逃脱 n. 逃走 adj. 使逃避困难的 
especially	[ɪˈspeʃəli, ɛˈspɛʃəli, ɪˈspɛʃ-] adv. 尤其地 
essay	[ˈɛsˌe, ɛˈse, ˈeseɪ] n. 散文;随笔，杂记文 vt. 尝试;试验 
essential	[ɪˈsenʃl, ɪˈsɛnʃəl] adj. 必要的;本质的 n. 必需品;基本要素 
establish	[ɪˈstæblɪʃ] vt. 建立，创建 
estate	[ɪˈsteɪt, ɪˈstet] n. 财产，遗产，房地产;个人财产 adj. （汽车）连箱的（拥有较长的车身和后门，后座后面有较大的空间） 
estimate	[ˈestɪmət, ˈɛstəˌmet] n. 估计，预测;报价，预算书 vt. 估计，估算;评价，评论 
eternal	[ɪˈtɜ:rnl, ɪˈtɜ:nl] adj. 永生的;不朽的 n. 永恒的事物;Eternal 上帝，与定冠词the 连用 
Europe	[ˈjʊrəp, ˈjʊərəp] n. 欧洲 
European	[ˌjʊərəˈpi:ən, ˌjʊrəˈpi:ən] adj. 欧盟的;欧洲的，欧洲人的 n. 欧洲人 
Eve	[i:v, iv] n. 夏娃（基督教<圣经>故事人物） 
even	[ˈivən, ˈi:vn] adv. 甚至 adj. 公平的 vt. 使平坦 vi. 变平 
evening	[ˈi:vnɪŋ, ˈivnɪŋ] n. 傍晚 adj. 在晚上的 int. 晚上好 
event	[ɪˈvent, ɪˈvɛnt] n. 事件，大事 
eventually	[ɪˈventʃuəli, ɪˈvɛntʃuəli] adv. 终究 
ever	[ˈevə(r), ˈɛvɚ] adv. 永远 
every	[ˈevri, ˈɛvri] det. 每 
everybody	[ˈevribɒdi, ˈevribɑ:di] pron. 各位 
everyday	[ˈevrideɪ, ˈɛvriˈde] adj. 每天的 
everyone	[ˈevriwʌn, ˈɛvriˌwʌn] pron. 每人，人人 
everything	[ˈevriθɪŋ, ˈɛvriˌθɪŋ] pron. 每件事物 
everywhere	[ˈevriweə(r), ˈevriwer] adv. 到处，处处，无论什么地方 
evidence	[ˈɛvɪdəns, ˈevɪdəns] n. 证据;迹象 vt. 表明;使明显 
evident	[ˈevɪdənt, ˈɛvɪdənt] adj. 明显的，明白的 
evil	[ˈi:vl, ˈivəl] adj. 邪恶的，罪恶的;有害的 n. 灾祸;邪恶，罪恶 
exact	[ɪɡˈzækt, ɪgˈzækt] adj. 准确的;严密的 vt. 要求;苛求 
exactly	[ɪɡˈzæktli, ɪgˈzæktli] adv. 恰恰 
exam	[ɪgˈzæm, ɪɡˈzæm] n. 测验 
examine	[ɪɡˈzæmɪn, ɪgˈzæmɪn] vt. 检查，调查;考试 vi. 检查;调查 
example	[ɪgˈzɑ:mpl, ɪgˈzæmpl] n. 例子 vt. 作为…的例子 vi. 举例 
exceedingly	[ɪkˈsi:dɪŋli, ɪkˈsidɪŋli] adv. 非常，极其，特别，十分 
excellent	[ˈeksələnt, ˈɛksələnt] adj. 优秀的 
except	[ɪkˈsept, ɪkˈsɛpt] vt. 把…除外 prep. 除…外 conj. 除非 vi. 反对，表示异议（与 to 或 against连用） 
exchange	[ɪksˈtʃendʒ, ɪksˈtʃeɪndʒ] n. 交换 vt. 兑换 vi. 交换，替换 
excite	[ɪkˈsaɪt] vt. 激发 
exciting	[ɪkˈsaɪtɪŋ] adj. 使人兴奋的，令人激动的 v. 刺激（excite的现在分词） 
exclusive	[ɪkˈsklu:sɪv, ɪkˈsklusɪv] adj. 专用的;高级的 n. 独家新闻;专有物 
excuse	[ɪkˈskju:s, ɪkˈskjuz] vt. 原谅 n. 辩解 vi. 作为借口 
executive	[ɪgˈzekjətɪv, ɪɡˈzɛkjətɪv] n. 总经理;行政部门 adj. 执行的;管理的 
exercise	[ˈeksəsaɪz, ˈeksərsaɪz] n. 练习 vi. 锻炼，训练，练习 vt. 锻炼（身体某部位） 
exhaust	[ɪgˈzɔ:st, ɪɡˈzɔst] vt. 排出 vi. 排气 n. 排出 
exhibit	[ɪgˈzɪbɪt, ɪɡˈzɪbɪt, ɛɡ-] vt. 呈现 vi. 展出 n. 展览，陈列 
exhibition	[ˌɛksəˈbɪʃən, ˌeksɪˈbɪʃn] n. 陈列，展览 
exist	[ɪgˈzɪst, ɪɡˈzɪst] vi. 存在 
existence	[ɪɡˈzɪstəns, ɪgˈzɪstəns] n. 存在，实在 
exit	[ˈɛɡzɪt, ˈɛksɪt, ˈeksɪt] n. 退场;出口，通道 vi. 退出;退场 
expand	[ɪkˈspænd] vt. 扩张;使…变大 vi. 扩展;展开 
expansion	[ɪkˈspænʃən, ɪkˈspænʃn] n. 扩张 
expect	[ɪkˈspekt, ɪkˈspɛkt] vt. 期望;预料 vi. 期待;预期 
expectation	[ˌɛkspɛkˈteʃən, ˌekspekˈteɪʃn] n. 预期 
expedition	[ˌekspəˈdɪʃn, ˌɛkspɪˈdɪʃən] n. 考察，远航 
expense	[ɪkˈspens, ɪkˈspɛns] n. 费用;花费的钱 vt. 向…收取费用;把…作为开支勾销 
expensive	[ɪkˈspensɪv, ɪkˈspɛnsɪv] adj. 昂贵的，花钱多的 
experience	[ɪkˈspɪriəns, ɪkˈspɪəriəns] n. 经验，体验;经历，阅历 vt. 感受;亲身参与，亲身经历 
experiment	[ɪkˈspɛrəmənt, ɪkˈsperɪmənt] n. 尝试;实验，试验 vi. 尝试;做实验，进行试验 
expert	[ˈekspɜ:t, ˈekspɜ:rt] n. 专家，能手 adj. 专家的 vt. 以专家身份研究（或检查），像专家那样研究（或检查） vi. 做专家工作，担任专家，成为高手（或能手） 
explain	[ɪkˈspleɪn, ɪkˈsplen] vt.&vi. 讲解，解释 vt. 说明…的原因，辩解 vi. 说明，解释，辩解 
explanation	[ˌekspləˈneɪʃn, ˌɛkspləˈneʃən] n. 解释 
explode	[ɪkˈsploʊd, ɪkˈspləʊd] vi. 爆[突]发，发怒;激增，迅速扩大 vt. （使）爆炸;突然（发出巨响，活跃起来，迸发感情） 
exploit	[ɪkˈsplɔɪt] vt. 开拓;剥削 n. 功绩;功劳 
explosion	[ɪkˈsploʊʒn, ɪkˈspləʊʒn] n. 爆发 
explosive	[ɪkˈsploʊsɪv, ɪkˈspləʊsɪv] adj. 爆炸的;易爆炸的 n. 爆炸物，炸药;[语言学] 爆破音 
export	[ˈekspɔ:rt, ˈekspɔ:t] vt.&vi. 出口，输出 vt. 传播，输出（思想或活动） 
expose	[ɪk'spəʊz, ɪkˈspoʊz] vt. 揭露，揭发 
express	[ɪkˈspres, ɪkˈsprɛs] v. 表达 adj. 特快的 n. 特快列车 adv. 使用快速服务 
expression	[ɪkˈsprɛʃən, ɪkˈspreʃn] n. 表现，表示，表达 
extend	[ɪkˈstɛnd, ɪkˈstend] vt.&vi. 延伸 vt. 延长 vi. 延伸 
extensive	[ɪkˈstensɪv, ɪkˈstɛnsɪv] adj. 广阔的，广大的 
extent	[ɪkˈstɛnt, ɪkˈstent] n. 程度 
extra	[ˈekstrə, 'ekstrə] adj. 额外的，补充的，附加的 n. 附加物，额外的事物 adv. 额外地 
extraordinary	[ɪkˈstrɔ:rdəneri, ɪkˈstrɔ:dnri] adj. 非凡的 
extreme	[ɪkˈstrim, ɪkˈstri:m] adj. 极端的，过激的;极限的，非常的 n. 极端;困境 
extremely	[ɪk'strimlɪ, ɪkˈstri:mli] adv. 极端地 
eye	[aɪ] n. 眼睛;视力 vt. 定睛地看;注视 
fable	[ˈfebəl, ˈfeɪbl] n. 传说;寓言，童话 v. 讲故事，编寓言;虚构，杜撰 
face	[feɪs, fes] n. 脸 vt.&vi. 面对 vt. （感到不能）对付 
facility	[fəˈsɪləti] n. 设备 
fact	[fækt] n. 实际 
factor	[ˈfæktə(r), ˈfæktɚ] n. 因素 vt. 把…因素包括进去 vi. 做代理商（或管家） 
factory	[ˈfæktri, ˈfæktəri] n. 工厂，制造厂 
fade	[fed, feɪd] vi. 褪去，失去光泽 vt. 使褪色 adj. 乏味的，平淡的 
fail	[fel, feɪl] vt.&vi. 失败，不及格 vi. 破产 vt. 不及格 n. 失败，失误 
failure	[ˈfeɪljə(r), 'feɪljər] n. 失败，不及格 
faint	[feɪnt, fent] adj. 微弱的，模糊的 vi. 头晕，昏过去 n. 昏厥，昏倒 
fair	[feə(r), fer] adj. 公平的 adv. 公平地 n. 集市，庙会 vt. （卡通制作）顺利接合 vi. 转晴 
fairly	[ˈfeəli, ˈferli] adv. 公平地 
faith	[feθ, feɪθ] n. 忠诚;信用，信任 int. 实在，确实 
faithful	[ˈfeθfəl, ˈfeɪθfl] adj. 忠实的;忠诚的 n. 信徒 
fall	[fɔ:l, fɔl] v. 落下;跌倒 n. 落下;瀑布 
false	[fɔ:ls] adj. 虚伪的;不正的，非法的 adv. 欺诈地;叛卖地 
fame	[feɪm, fem] n. 名声;名望 vt. 使闻名;使出名 
familiar	[fəˈmɪljɚ, fəˈmɪliə(r)] adj. 熟悉的;通晓的 n. 常客，密友;高级官吏的家属 
family	[ˈfæmli, ˈfæməli] n. 家庭;家族 adj. 家庭的;一家所有的 
famous	[ˈfeɪməs, ˈfeməs] adj. 著名的，出名的 
fan	[fæn] n. 扇子，风扇 vt. 扇动 vi. 成扇形 
fancy	[ˈfænsi] vt. 想像 n. 设想 adj. （构思者）奇特的 vi. 想象，幻想 
far	[fɑ:(r), fɑr] adv. 久远地 adj. 远的 n. 远方 
fare	[feə(r), fer] n. 票价;费 vi. 吃;进食 
farewell	[ˌfeəˈwel, ˌferˈwel] n. 告别，欢送 int. 再见，再会 adj. 告别的，送行的 
farm	[fɑ:m, fɑ:rm] n. 农家 vt. 养殖 vi. 经营农场 
farmer	[ˈfɑ:mə(r), ˈfɑ:rmə(r)] n. 农场主，农民 
farther	[ˈfɑ:rðə(r), ˈfɑ:ðə(r)] adv. 进一步;更远地 adj. 更远的;远的( far的比较级) 
fascinate	[ˈfæsəˌnet, ˈfæsɪneɪt] vt. 蛊惑;使着迷 vi. 入迷 
fashion	[ˈfæʃn, ˈfæʃən] n. 时尚，时装;时装领域，时尚界 vt. 制作，塑造;使适应 
fashionable	[ˈfæʃənəbəl, ˈfæʃnəbl] adj. 流行的;时髦的，符合时尚的 n. 时髦的人 
fast	[fæst, fɑ:st] adj. 快的 adv. （比准确的时间或宣布的时间）快 vi. 禁食，（尤指）斋戒 n. 禁食期，斋戒期 
fasten	[ˈfɑ:sn, ˈfæsn] vt. 系牢，钉牢;使坚固或稳固 vi. 附着，扣紧;紧握，紧抱 
fat	[fæt] adj. 胖的 n. 脂肪 vt. 养肥 vi. 长肥 
fatal	[ˈfeɪtl, ˈfetl] adj. 致命的，攸关的 
fate	[fet, feɪt] n. 命运，宿命;灾难，死亡 v. 注定 
father	[ˈfɑðɚ, ˈfɑ:ðə(r)] n. 父亲;天父 vt. 成为父亲;创立（新思想） 
father-in-law	[ˈfɑðərɪnˌlɔ, 'fɑ:ðə(r) ɪn lɔ:] n. 岳父 
fault	[fɔ:lt, fɔlt] n. 缺点，缺陷 vt. 挑剔，找…的缺点 vi. 找错误，挑剔 
faulty	[ˈfɔ:lti, ˈfɔlti] adj. 错误的 
favour	[ˈfeɪvə(r), ˈfevɚ] n. 恩惠;赞同 vt. 有利于;赞同 
favourable	[ˈfeɪvərəbl] adj. 有利的 
favourite	[ˈfeɪvərɪt, 'fevərɪt] adj. 特别受喜爱的 n. 特别喜爱的人（或物） 
fax	[fæks] n. 传真 vt. 传真;传真传输 
fear	[fɪə(r), fɪr] n. 害怕 vt. 害怕 vi. 害怕 
feast	[fi:st, fist] n. 宴会 vi. 大吃大喝，享用美食 vt. 款待（某人），宴请（某人） 
feather	[ˈfeðə(r), ˈfɛðɚ] n. 羽毛，翎毛;状态，心情 v. 给装上羽毛，用羽毛装饰;使（桨）与水面平行 
feature	[ˈfi:tʃə(r), ˈfitʃɚ] n. 特征，特点 vt. 使有特色 vi. 起主要作用 
February	[ˈfebrueri, ˈfebruəri] n. 二月 
federal	[ˈfɛdərəl, ˈfɛdrəl, ˈfedərəl] adj. 联邦（制）的;同盟的 n. 联邦主义者;同盟盟友 
fee	[fi:, fi] n. （加入组织或做某事付的）费;专业服务费，业务报酬 vt. 付给报酬，给小费;〈英〉雇用，聘请 
feed	[fid, fi:d] vt. 喂养 vi. 吃，以…为食 n. 饲料（尤指粗饲料），施肥 
feedback	[ˈfidˌbæk, ˈfi:dbæk] n. 反馈 
feel	[fil, fi:l] vt. 感觉 vt.&vi. 感觉，觉得 n. 感觉 vi. 觉得 
feeling	[ˈfi:lɪŋ, ˈfilɪŋ] n. 感情 adj. 富有感情的，有感觉的 v. 感觉 
fell	[fel, fɛl] vt. 砍倒，打倒 n. 兽皮 adj. 残忍的 v. 摔倒 
fellow	[ˈfeləʊ, ˈfeloʊ] n. 同伴 adj. 同伴的 vt. 使…与另一个对等 
female	[ˈfi:meɪl,  ˈfiˌmel] adj. 女性的;雌性的 n. 女人;雌性动物 
fence	[fɛns, fens] n. 围墙 vt. 用篱笆围住 vi. 练习击剑 
ferry	[ˈfɛri, ˈferi] n. 渡船 vt. 航海 vi. 摆渡 
fertilizer	[ˈfɜ:rtəlaɪzə(r), ˈfɜ:təlaɪzə(r)] n. 肥料，化肥 
festival	[ˈfestɪvl,  ˈfɛstəvəl] n. 节日;节期 adj. 节日的，喜庆的 
fetch	[fetʃ, fɛtʃ] vt. 接来（某人） vi. 取来 n. 拿取，拿来 
fever	[ˈfi:və(r), ˈfivɚ] n. 热病 vt. 引起发热 vi. 狂热 
few	[fju, fju:] adj. 很少 pron. 很少 n. 很少数 
fiction	[ˈfɪkʃn, ˈfɪkʃən] n. 小说，虚构的文学作品 
field	[fild, fi:ld] n. 田 vi. [棒球、板球等]担任外场员，担任守队队员 adj. 实地的 vt. 保护 
fierce	[fɪəs, fɪrs] adj. 猛烈的 
fifteen	[ˌfɪfˈti:n, fɪfˈtin] n. 十五 
fifth	[fɪfθ] num. 第五 n. 五分之一;第五音，五度音程 
fifty	[ˈfɪfti] n. 五十岁 num. 五十 adj. 五十的 
fight	[faɪt] vt.&vi. 战斗;斗争 n. 战斗;打架 
figure	[ˈfɪgjər, ˈfɪgə(r)] n. 人物 vi. 计算 vt. 计算在内 
file	[faɪl] vt. 提出（离婚诉讼或其他讼案） vi. 发送（报道给报社） n. 档案 
fill	[fɪl] vt.&vi. （使）充满，（使）装满 vt. 满足 n. 填满…的量 
film	[fɪlm] n. 电影 vt.&vi. （把…）拍摄（成）电影[电视等] vt. （给…）覆上一薄层 
final	[ˈfaɪnl, ˈfaɪnəl] adj. 最后的，最终的;决定性的 n. 决赛;结局 
finally	[ˈfaɪnəli] adv. 总算 
finance	[ˈfaɪnæns, fəˈnæns, faɪ-, ˈfaɪˌnæns] n. 金融;财政 vt. 为…供给资金， 从事金融活动;赊货给… 
financial	[faɪˈnænʃ(ə)l, faɪˈnænʃl] adj. 金融的 
find	[faɪnd] v. 找到;发现 n. 发现物;被发现的人 
fine	[faɪn] adj. 好的，上等的 n. 罚款 vt. 罚款 adv. 很好地 
finger	[ˈfɪŋɡɚ, ˈfɪŋgə(r)] n. 手指 vt. 伸出 vi. 用手指触摸 
finish	[ˈfɪnɪʃ] vt.&vi. 完成;结束 n. 结束;结尾 
finite	[ˈfaɪnaɪt, ˈfaɪˌnaɪt] adj. 有限的;[语]限定的 n. 有限性;有限的事物 
fire	[ˈfaɪə(r), faɪr] n. 火灾 vt.&vi. 开火，射击 vt. <口>解雇 
fireman	[ˈfaɪərmən, ˈfaɪəmən] n. 消防队员 
firm	[fɜ:m, fɜ:rm] adj. 坚固的，坚牢的 vt.&vi. 使坚固 n. 公司 adv. 坚定地，稳固地 vt. 使坚定，使牢固 vi. 变坚实，变稳固 
first	[fɜ:st, fɜ:rst] n. 第一，最初 adv. 首次 adj. 第一流的 num. 第一 
fish	[fɪʃ] n. 鱼，鱼肉，鱼类 vt.&vi. 钓鱼 vt. 钓鱼，捕鱼 vi. 捕鱼，钓鱼 
fishery	[ˈfɪʃəri] n. 渔场 
fist	[fɪst] n. 拳，拳头;〈口〉笔迹 vt. 紧握;握成拳 
fit	[fɪt] vt.&vi. 安装 adj. 合适的 n. 适合 
five	[faɪv] num. 第五 n. 五，五个 adj. 五的 
fix	[fɪks] vt. 固定 vi. 固着 n. 困境 
flag	[flæɡ, flæg] n. 旗 vt. 标示 vi. 疲乏，变弱，热情衰减 
flame	[flem, fleɪm] n. 火焰 vi. 燃烧，发出火焰 vt. 烧 
flash	[flæʃ] vt.&vi. 使闪光，使闪烁 n. 闪光 adj. 闪光的，闪耀的，一闪而过的 
flat	[flæt] adj. 平的 adv. （尤指贴着另一表面）平直地 n. 平面 vt. 使变平 vi. 逐渐变平 
flavour	[ˈflevɚ, ˈfleɪvə(r)] n. 风味，情趣;味，滋味 vt. 给…添风味[添情趣，添风趣];给…增加香气 
flee	[fli, fli:] vi. 逃走，逃掉;消失 vt. 逃离，逃避 
fleet	[fli:t, flit] n. 舰队 adj. 快速的，敏捷的 vi. 疾驰 vt. 使（时间）飞逝 
flesh	[fleʃ, flɛʃ] n. 肉;肉体 v. 用肉喂养;长胖 
flexible	[ˈfleksəbl, ˈflɛksəbəl] adj. 灵活的 
flight	[flaɪt] n. 航班 vi. 成群地迁徙或飞行 vt. 射击 
float	[fləʊt, floʊt] vt.&vi. （使）浮动 vi. 游荡 vt. 提出，提请考虑 n. 彩车 
flock	[flɒk, flɑ:k] n. 兽群，鸟群 vi. 群集，成群结队而行 vt. 用棉束填 
flood	[flʌd] n. 洪水 vi. 涌出 vt. 淹没 
floor	[flɔr, flor, flɔ:(r)] n. 楼层;地面，地板 vt. 铺地板;击败，打倒 
flour	[ˈflaʊə(r), flaʊr] n. 面粉 vt. 撒上粉 
flourish	[ˈflɜ:rɪʃ, ˈflʌrɪʃ] vi. 挥舞 vt. 挥动，挥舞 n. 挥舞，挥动 
flow	[floʊ, fləʊ] vi. 流 n. 流动 vt. 使泛滥 
flower	[ˈflaʊə(r), ˈflaʊɚ] n. 花 vi. 开花 vt. 使开花 
flu	[flu, flu:] n. 流行性感冒，流感 
fluid	[ˈflu:ɪd, ˈfluɪd] n. 液体，流体 adj. 流体的，流动的，流体的，液体的;易变的，不固定的 
flush	[flʌʃ] vi. 冲刷 adj. 满面红光的 n. 奔流，涌出 vt. 发红或发亮 
fly	[flai, flaɪ] vi. 飞 vt.&vi. 乘（…的）飞机 vt. 驾驶 n. 苍蝇 
focus	[ˈfoʊkəs, ˈfəʊkəs] vt.&vi. （使）集中，（使）聚集 vt. 调整（眼睛或者镜头的）焦距 n. 焦点 
fog	[fɔ:g, fɒg] n. 雾 vt. 以雾包围 vi. 为雾笼罩 
fold	[foʊld, fəʊld] vt. 折叠 vi. 折叠起来 n. 折痕 
folk	[foʊk, fəʊk] n. 民族;人们 adj. 民间的;普通平民的 
follow	[ˈfɒləʊ, ˈfɑ:loʊ] vt.&vi. 跟随，接着 vt. 继承 vi. 理解 n. 追随，跟随 
fond	[fɒnd, fɑ:nd] adj. 喜欢的 
food	[fud, fu:d] n. 粮食 
fool	[ful, fu:l] n. 愚人，傻瓜 vt. 愚弄，欺骗 vi. 欺骗 adj. 愚蠢的 
foolish	[ˈfulɪʃ, ˈfu:lɪʃ] adj. 愚蠢的 
foot	[fʊt] n. 脚 vt. 走，踏 vt.&vi. 结算，总计，共计 
football	[ˈfʊtbɔ:l, ˈfʊtˌbɔl] n. 足球运动 
for	[fɔr,fə, fə(r)] prep. 为，为了;倾向于 conj. 因为，由于 
forbid	[fəˈbɪd, fərˈbɪd] vt. 禁止 
force	[fɔ:s, fɔ:rs] n. 力;武力 vt. 强迫;强行 
forecast	[ˈfɔ:kɑ:st, ˈfɔ:rkæst] vt. 预报，预测 vi. 预报，预测 n. 预报 
forefather	[ˈfɔ:fɑ:ðə(r), ˈfɔ:rfɑ:ðə(r)] n. 祖先，祖宗 
foreign	[ˈfɒrən, ˈfɔ:rən] adj. 外国的，外交的 
foreigner	[ˈfɔ:rənə(r), ˈfɒrənə(r)] n. 外国人 
forest	[ˈfɒrɪst, ˈfɔ:rɪst] n. 森林;丛林 vt. 在…造林，使长满树林，使成为森林 
forever	[fərˈevə(r), fɔrˈɛvɚ, fə-] adv. 永远;不断地，无休止地 n. 永恒;极长的一段时间 
forget	[fəˈget, fərˈget] vt. 忘掉;忘记，忘却 vi. 忘记;忽视 
forgive	[fəˈgɪv, fərˈgɪv] vt.&vi. 原谅; 饶恕 vt. 免除 
fork	[fɔ:k, fɔ:rk] n. 餐叉 vi. 分叉 vt. 走岔路 
form	[fɔ:m, fɔ:rm] n. 表格 vt. 形成 vi. 形成，产生 
formal	[ˈfɔ:ml, ˈfɔ:rml] adj. （学校教育或培训）正规的;方式上的 n. <美>须穿礼服的社交集会;<口>夜礼服 
format	[ˈfɔ:mæt, ˈfɔ:rmæt] n. （出版物的）版式 vt. 使格式化 vi. 设计一个版式 
former	[ˈfɔ:mə(r), ˈfɔ:rmə(r)] adj. 以前的，从前的;在前的 n. 模型，样板;构成者，创造者 
forth	[fɔ:θ, fɔ:rθ] adv. 向前，向前方;露着的，往外的 prep. 出自，从…离开 
fortnight	[ˈfɔ:rtnaɪt, ˈfɔ:tnaɪt] n. 两星期，十四天 
fortunate	[ˈfɔ:tʃənət, ˈfɔ:rtʃənət] adj. 侥幸的，幸运的;带来幸运的，吉利的 n. 有好运的人 
fortune	[ˈfɔ:rtʃu:n, ˈfɔ:tʃu:n] n. 幸运 vt. 给予财富 vi. 偶然发生 
forty	[ˈfɔ:ti, ˈfɔ:rti] n. 四十;四十几 adj. 四十的 
forum	[ˈfɔ:rəm, ˈfɔrəm] n. 论坛，讨论会，专题讨论节目 
forward	[ˈfɔ:wəd, ˈfɔ:rwərd] adv. 向前 adj. 向前方的 vt. 促进，助长 n. 前锋 
found	[faʊnd] vt. 创办，成立，建立 v. 找到;发现（ find的过去式） 
foundation	[faʊnˈdeɪʃn, faʊnˈdeʃən] n. 基础 
four	[fɔr, fɔ:(r)] num. 四;四个 n. 四的;四个一组之物 
fourteen	[ˌfɔ:ˈti:n, ˌfɔ:rˈti:n] num. 十四;十四个 n. 十四的记号;十四岁 
fourth	[fɔ:θ, fɔ:rθ] n. 第四 adj. 第四的 num. 第四 
fox	[fɑ:ks, fɒks] n. 狐狸 vt. 欺骗 vi. 耍花招 
fragile	[ˈfrædʒaɪl, ˈfrædʒl] adj. 易碎的，脆的 
fragrant	[ˈfreɪgrənt, ˈfreɡrənt] adj. 芳香的，香的 
frame	[frem, freɪm] n. 框架 vt. 陷害 adj. 有木架的，有构架的 
framework	[ˈfreɪmwɜ:k, ˈfreɪmwɜ:rk] n. 框架 
France	[frɑ:ns, fræns] n. [地名]法国，法兰西 
frank	[fræŋk] adj. 坦白的，直率的 n. 弗兰克 vt. 免费寄（邮件） 
free	[fri, fri:] adj. 免费的 adv. 免费地 vt. 释放 
freedom	[ˈfridəm, ˈfri:dəm] n. 自由，自主 
freeze	[friz, fri:z] vt. 使结冰，使冻僵 vi. 凝固，结冰 n. 冻结 
freight	[freɪt, fret] n. 运费;货运，货物 vt. 运输;装货于 
French	[frentʃ, frɛntʃ] adj. 法语的;法国的，法国人的 n. 法语;法国人 
Frenchman	[ˈfrɛntʃmən, 'frentʃmən] n. 法国人 
frequency	[ˈfri:kwənsi, ˈfrikwənsi] n. 频繁性 
fresh	[frɛʃ, freʃ] adj. 新鲜的 adv. 刚 n. 开始 
Friday	[ˈfraɪdeɪ, ˈfraɪˌdeɪ] n. 星期五，周五，礼拜五 
friend	[frend, frɛnd] n. 朋友，友人;资助者 v. <诗>与…为友 
friendly	[ˈfrendli, ˈfrɛndli] adj. 友好的，亲密的;有帮助的 n. 友谊赛 
friendship	[ˈfrɛndˌʃɪp, ˈfrendʃɪp] n. 友情，友谊 
fright	[fraɪt] n. 惊吓;恐怖 v. 使惊恐 
frighten	[ˈfraɪtn] vt. 使惊恐，使恐慌;吓走，赶走 vi. 害怕，惊恐 
frog	[frɔ:g, frɒg] n. 青蛙 
from	[frəm, frʌm] prep. （表示时间）从… 
front	[frʌnt] n. 前面 adj. 前面的 v. 面向 
frontier	[ˈfrʌntɪə(r), frʌnˈtɪr] n. 边疆，边境;边界，边缘 adj. 边疆的，边界的;新垦地的，边地的 
frost	[frɒst, frɔ:st] vt.&vi. 使结冰霜 vi. 结霜 n. 霜冻，结霜 
frown	[fraʊn] vt.&vi. 皱眉;不同意 n. 皱眉，蹙额 
frozen	[ˈfrəʊzn, ˈfroʊzn] adj. 冷冻的;冰封的 v. 冻结;冷藏 
fruit	[fru:t, frut] n. 水果 vi. 树或花草结果 vt. 使…结果实 
fry	[fraɪ] n. 鱼苗，鱼秧 vi. 油炸 vt. 油炸 
fuel	[ˈfjuəl, ˈfju:əl] n. 燃料 vt. 给…加燃料，给…加油 vi. 补充燃料 
fulfill	[fʊlˈfɪl, fʊl'fɪl] vt. 履行（诺言等） 
full	[fʊl] adj. 满的，装满的 adv. 极其，十分 n. 全部 v. 把衣服缝得宽大 
fun	[fʌn] n. 乐趣 adj. 开心的 vi. 嬉闹 
function	[ˈfʌŋkʃən, ˈfʌŋkʃn] n. 功能，作用;应变量，函数 vi. 有或起作用;行使职责 
fund	[fʌnd] n. 基金;储备 vt. 积存;为…提供资金 
fundamental	[ˌfʌndəˈmentl, ˌfʌndəˈmɛntl] adj. 基础的，基本的，根本的，重要的，原始的，主要的，十分重大的;[物]基频的，基谐波的 n. 原理，原则，基本，根本，基础;[乐]基音 
funeral	[ˈfjunərəl, ˈfju:nərəl] n. 葬礼，丧礼;〈比喻〉不愉快的事，操心的事，有关系的事 adj. 葬礼的;出殡用的，出殡时的 
funny	[ˈfʌni] adj. 有趣的，好笑的，滑稽的;（口）稀奇的，古怪的，奇异的 n. 滑稽人物;笑话，有趣的故事 
fur	[fɚ, fɜ:(r)] n. 毛皮 adj. 含羊毛的 vt. 用毛皮覆盖 
furious	[ˈfjʊriəs, ˈfjʊəriəs] adj. 激烈的 
furnish	[ˈfɜ:nɪʃ, ˈfɜ:rnɪʃ] vt. 陈设，布置 
furniture	[ˈfɜ:nɪtʃə(r), ˈfɜ:rnɪtʃə(r)] n. 家具 
further	[ˈfɜ:rðə(r), ˈfɜ:ðə(r)] adj. 更多的 adv. 进一步地 vt. 促进，推动 
furthermore	[ˌfɜ:rðərˈmɔ:r, ˌfɜ:ðəˈmɔ:(r)] adv. 此外 
future	[ˈfju:tʃə(r), ˈfjutʃɚ] adj. 将来的，未来的;[语法学]将来时的 n. 前途;期货 
gain	[geɪn, ɡen] vt.&vi. 获得 n. 利润 vt. （在…上）开腰槽 vi. 增进 
gallon	[ˈgælən, ˈɡælən] n. 加仑（容量单位） 
game	[geɪm, ɡem] n. 游戏，运动 adj. 受伤的，瘸的 v. 打赌，赌输赢 
gang	[gæŋ, ɡæŋ] n. 帮派，团体 vt. 使结成一帮 vi. 结伙行动 
gap	[gæp, ɡæp] n. 缺口 vt. 造成缝隙 vi. 豁开 
garage	[gəˈrɑ:ʒ, ˈgærɑ:ʒ] n. 车库;汽车修理站 vt. 把…送入车库;把（汽车）开进车库 
garbage	[ˈgɑ:bɪdʒ, ˈgɑ:rbɪdʒ] n. 垃圾 
garden	[ˈgɑ:rdn, ˈgɑ:dn] n. 公园 vt. 造园，开辟（一小片土地）作为花园 vi. 从事园艺 adj. 花园的，园艺的 
garment	[ˈgɑ:mənt, ˈgɑ:rmənt] n. 服装;衣服 v. 给…穿衣服 
gas	[gæs, ɡæs] n. 气体 vt. 加油 vi. 加油 int. 该死！（令人气愤的人应即被送毒气室处死） 
gaseous	[ˈgæsiəs, ˈɡæsiəs, ˈɡæʃəs] adj. 气态的，似气体的 
gate	[geɪt, ɡet] n. 门;闸门 vt. 给…装大门;[电子学] 电波传送 
gather	[ˈgæðə(r), ˈɡæðɚ] vt. 收集 vi. 逐渐增加，积聚 n. 聚集 
gay	[geɪ, ɡeɪ] adj. 同性恋的;快乐的，愉快的 n. 同性恋者（尤指男性） 
gaze	[geɪz, ɡez] vi. 凝视，注视 n. 凝视，端详 
general	[ˈdʒenrəl, ˈdʒɛnərəl] adj. 普遍的;大致的 n. 一般;常规 
generous	[ˈdʒɛnərəs, ˈdʒenərəs] adj. 慷慨的，大方的 
genius	[ˈdʒi:niəs, ˈdʒinjəs] n. 天才 
gentle	[ˈdʒɛntl, ˈdʒentl] adj. 温和的 vt. 使温和 n. 蛆 
gentleman	[ˈdʒentlmən, ˈdʒɛntlmən] n. 绅士 
genuine	[ˈdʒɛnjuɪn, ˈdʒenjuɪn] adj. 真正的 
geography	[dʒiˈɒgrəfi, dʒiˈɑ:grəfi] n. 地理（学） 
germ	[dʒɜ:m, dʒɜ:rm] n. 微生物 
German	[ˈdʒɜ:rmən, ˈdʒɜ:mən] adj. 德国的;德国人/语的 n. 德国人，德语 
Germany	['dʒɜ:mənɪ, ˈdʒəməni]  德国（欧洲国家） 
gesture	[ˈdʒɛstʃɚ, ˈdʒestʃə(r)] n. 手势，姿势 vt. 做手势 vi. 用手势表现，表达或指导 
get	[get, ɡɛt] vt. 得到 vt.&vi. 到达，来 vi. 成为 n. 生殖，幼兽 
ghost	[goʊst, gəʊst] n. 鬼，幽灵 vt. 悄悄地行进 vi. 替人代笔 
giant	[ˈdʒaɪənt] n. 巨人，大汉;巨兽，巨物 adj. 特大的，巨大的;伟大的 
gift	[gɪft, ɡɪft] n. 天赋;赠送 vt. 赋予;向…赠送 
gigantic	[dʒaɪˈɡæntɪk, dʒaɪˈgæntɪk] adj. 巨大的，庞大的 
girl	[gɜ:l, gɜ:rl] n. 女孩 
give	[ɡɪv, gɪv] vt.&vi. 给予 vt. 供给 vi. （物体）塌下 n. 伸展性，弹性 
glad	[glæd, ɡlæd] adj. 高兴的，乐意的;令人高兴的，使人愉快的 vt. 使高兴 
glance	[glɑ:ns, glæns] vi. 一瞥;闪微光 n. 浏览;闪光 
glare	[gleə(r), gler] vt.&vi. 怒目而视 vi. 发强光 n. 强光 
glass	[glɑ:s, glæs] n. 玻璃 vt. 给某物加玻璃 vi. 成玻璃状 
glide	[glaɪd, ɡlaɪd] n. 滑行，滑翔 vt. （鸟或飞机）滑翔，滑动 vi. 使滑行 
glimpse	[glɪmps, ɡlɪmps] n. 一瞥，一看;（古语）闪光 vi. 瞥见 
glitter	[ˈglɪtə(r), ˈɡlɪtɚ] vi. 闪烁，闪耀;华丽夺目，炫耀 n. 闪烁;灿烂的光辉 
global	[ˈgləʊbl, ˈgloʊbl] adj. 全球的，全球性的，有关全球大局的 
globe	[gloʊb, gləʊb] n. 地球仪;球，球状物 v. （使）成球状 
gloomy	[ˈglu:mi, ˈɡlumi] adj. 黑暗的 
glorious	[ˈɡlɔriəs,ˈɡlor-, ˈglɔ:riəs] adj. 辉煌的 
glory	[ˈɡlɔri, ˈɡlori, ˈglɔ:ri] n. 光荣，荣誉;壮观，壮丽 vi. 得意，自豪;骄傲 
glove	[glʌv, ɡlʌv] n. 手套;棒球手套 vt. 给…戴手套;用…的手套 
glow	[gloʊ, gləʊ] vi. 发光，灼热;脸红 n. 白热，炽热;色彩鲜艳，尤指红光 
glue	[glu:, ɡlu] vt. 胶合;紧附于 n. 胶水;胶粘物 
go	[gəʊ, goʊ] vi. 走 vt. 变得 n. 轮到的顺序 
goal	[goʊl, gəʊl] n. 球门 
goat	[goʊt, gəʊt] n. 山羊 
god	[gɒd, gɑ:d] n. 上帝，造物主;被极度崇敬的人[物] vt. 膜拜;崇拜 
gold	[goʊld, gəʊld] n. 金色;金币 adj. 金色的;金（制）的，含金的 
golden	[ˈgəʊldən, ˈgoʊldən] adj. 金（黄）色的 
golf	[gɒlf, gɑ:lf] n. 高尔夫球;高尔夫球运动 vi. 打高尔夫球 
good	[gʊd, ɡʊd] adj. 好的 n. 好处，利益 adv. 同well 
good-by	[gʊd'baɪ] int. 再见！ n. 告别，再见，道别的话 
goodness	[ˈgʊdnəs, ˈɡʊdnɪs] n. 善良;上帝 int. 天哪，哎呀 
goods	[, gʊdz] n. 商品，货物 
goose	[gu:s, ɡus] n. 鹅;鹅肉 v. 拧或掐屁股;忽然加满油； 催促 
gossip	[ˈgɑ:sɪp, ˈgɒsɪp] n. 流言蜚语，谣言;爱讲闲话的人 vi. 传播流言，说长道短 
govern	[ˈgʌvn, ˈgʌvərn] vt. 治理;统治 vi. 控制，支配;操纵 
government	[ˈgʌvənmənt, ˈgʌvərnmənt] n. 政府 
governor	[ˈgʌvənə(r), ˈgʌvərnə(r)] n. 主管人员 
grab	[græb, ɡræb] vt.&vi. 抢先，抢占 vt. 夺取或抓住 vi. 夺取 n. 不法所得 
grace	[ɡres, greɪs] n. 优雅;恩泽 v. 使优美;惠赐 
graceful	[ˈgreɪsfl, ˈɡresfəl] adj. 优美的，优雅的 
gracious	[ˈgreɪʃəs, ˈɡreʃəs] adj. 亲切的，和蔼的;（对王族及其行为的敬语）仁慈的，谦和的 int. （表示惊异）天哪，老天爷 
grade	[greɪd, ɡred] n. 等级 vt. 评分 vi. 属于…等级 
gradual	[ˈgrædʒuəl, ˈɡrædʒuəl] adj. 渐进的，渐（升）降的;倾斜度小的 n. 弥撒升阶圣歌;弥撒圣歌集 
gradually	[ˈgrædʒuəli, ˈɡrædʒʊəlɪ] adv. 逐步地，渐渐地 
graduate	[ˈgrædʒuət, ˈɡrædʒuˌet] vi. 渐变 vt. 授予学位或毕业证书 n. <美>毕业生 adj. <美>毕业了的，研究生的 
grain	[ɡren, greɪn] n. 谷物，粮食 vt. 把…作成细粒 vi. 成谷粒 
grammar	[ˈgræmə(r), ˈɡræmɚ] n. 语法 
grammatical	[ɡrəˈmætɪkəl, grəˈmætɪkl] adj. 语法上的，符合语法规则的 
gramme	[ɡræm] n. 克 
grand	[ɡrænd, grænd] adj. 宏大的，宏伟的;（最）重要的 n. 一千美元;大钢琴 
granddaughter	[ˈgrændɔ:tə(r), ˈɡrænˌdɔtɚ] n. （外）孙女 
grandfather	[ˈgrænfɑ:ðə(r), ˈɡrændˌfɑðɚ, ˈɡræn-] n. （外）祖父;始祖 vt. 新规定限制;不受新条例 
grandmother	[ˈgrænmʌðə(r), ˈɡrændˌmʌðɚ, ˈɡræn-] n. 老奶奶 vt. 当…的祖母 vi. 当祖母 
grandson	[ˈɡrændˌsʌn, ˈɡræn-, ˈgrænsʌn] n. 孙子，外孙 
grant	[grɑ:nt, grænt] vt. 授予 n. 拨款 vi. 同意 
grape	[greɪp, ɡrep] n. 葡萄 
grasp	[grɑ:sp, græsp] vt. 抓住 n. 控制 vi. 攫取（常与 at 连用） 
grass	[græs, grɑ:s] n. 草，青草 vt. 用草覆盖 vi. 渐渐被草覆盖 
grateful	[ˈgreɪtfl, ˈɡretfəl] adj. 感激的，感谢的 
gratitude	[ˈgrætɪtju:d, ˈgrætɪtu:d] n. 谢意 
grave	[ɡreɪv, greɪv] adj. 严重的 adv. 沉重地，庄重地 n. 坟墓，墓穴 vt. 雕刻 
gray	[greɪ, ɡre] n. 灰色 adj. 灰色的 v. （使）变灰色 vi. 成为灰色或灰白 
great	[greɪt, ɡret] adj. 伟大的，杰出的 adv. [口语]很好地 n. 大人物们 
greedy	[ˈɡridi, ˈgri:di] adj. 贪婪的 
Greek	[ɡrik, gri:k] n. 希腊语;希腊人 adj. 希腊语的;希腊的，希腊人的 
green	[ɡrin, gri:n] adj. 绿色的 n. 绿色蔬菜 vi. 绿化，使重视环境保护问题 
greenhouse	[ˈɡrinˌhaʊs, ˈgri:nhaʊs] n. 温室，花房 
greet	[gri:t, ɡrit] vt. 打招呼 
greeting	[ˈɡritɪŋ, ˈgri:tɪŋ] n. 招呼，问候;敬礼 v. 迎接;问候(greet的现在分词) 
grieve	[ɡriv, gri:v] vt. 使伤心;使悲伤 vi. 悲伤;伤心 
grind	[graɪnd, ɡraɪnd] vt.&vi. 折磨 vt. 磨快，磨光 vi. 嘎吱嘎吱地擦 n. 碾，磨 
grip	[grɪp, ɡrɪp] n. 握力 vt. 握紧，抓牢 vi. 抓牢，紧握：保持紧握 
groan	[groʊn, grəʊn] vi. 呻吟 vt. 呻吟着说，呻吟着表示 n. 呻吟，叹息 
grocery	[ˈgrəʊsəri, ˈgroʊsəri] n. 食品杂货店 
gross	[groʊs, grəʊs] adj. 总的 n. 总额 vt. 总共收入 
ground	[graʊnd, ɡraʊnd] n. 地面，土地 vi. 搁浅，停飞 vt. 把…放在地上 v. grind的过去式和过去分词 
group	[gru:p, ɡrup] n. 组，团体 vt.&vi. 使成群，集合 vt. 分类，归类 
grow	[grəʊ, groʊ] vt. 种植 vi. 生长 vt.&vi. （使）留长，蓄长 
grown-up	[ɡrəʊn ʌp, ˈɡronˌʌp] adj. 成熟的;成年的，成人的 n. 成年人 
growth	[grəʊθ, groʊθ] n. 生长 
guarantee	[ˌgærənˈti:, ˌɡærənˈti] n. 保证，担保;保证人，保证书 vt. 保证，担保 
guard	[gɑ:d, gɑ:rd] n. 警卫 vt. 看守 vi. 警卫 
guess	[ges, ɡɛs] vt. 推测 vi. 猜，猜测 n. 猜测 
guest	[ɡɛst, gest] n. 客人 v. 做特邀嘉宾 adj. 客人的 
guidance	[ˈgaɪdns, ˈɡaɪdns] n. 导航 
guide	[gaɪd, ɡaɪd] vt. 指导;引路 n. 导游;向导 
guilty	[ˈgɪlti, ˈɡɪlti] adj. 有罪的 
gulf	[gʌlf, ɡʌlf] n. 海湾;波斯湾 vt. 吞没;卷进 
gum	[gʌm, ɡʌm] n. 口香糖;牙龈 vt.&vi. 胶合;涂以树胶 
gun	[gʌn, ɡʌn] n. 枪 vt. 射击（某人） vi. 用枪打猎 
guy	[gaɪ, ɡaɪ] n. 家伙，伙计 vt. （用牵索等）牵拉 vi. [俚语]逃亡，逃走 
habit	[ˈhæbɪt] n. 习惯，习性;气质 vt. 给…穿衣服;打扮 
hail	[heɪl, hel] n. 冰雹 vi. 下冰雹 vt. 致敬 
hair	[her, heə(r)] n. 头发，毛发 
haircut	[ˈheəkʌt, ˈherkʌt] n. 理发 
half	[hɑ:f, hæf] adj. 一半的，半个的 n. 半 adv. 一半 
hall	[hɔl, hɔ:l] n. 过道，走廊 
ham	[hæm] n. 火腿 vi. 表情夸张，表演过火 adj. 过火的，做作的 
hamburger	[ˈhæmbɜ:gə(r), ˈhæmbɜ:rgə(r)] n. 汉堡包 
hammer	[ˈhæmə(r), ˈhæmɚ] n. 链球 vt.&vi. 锤打 vt. 击败 
hand	[hænd] n. 手;协助，帮助 vt. 传递，交给;搀扶 
handbook	[ˈhændˌbʊk, ˈhændbʊk] n. 手册 
handful	[ˈhændfʊl, ˈhændˌfʊl] n. 少数，少量 
handicap	[ˈhændiˌkæp, ˈhændikæp] n. 障碍;缺陷 vt. 妨碍，使不利;使（某人）行动和生活不正常 
handkerchief	[ˈhæŋkətʃɪf, ˈhæŋkərtʃɪf] n. 手帕 
handle	[ˈhændl] n. 手柄 vi. 操作，操控 vt. 用双手触摸、举起或握住 
handsome	[ˈhænsəm] adj. 英俊的，健美的 
handwriting	[ˈhændraɪtɪŋ, ˈhændˌraɪtɪŋ] n. 书法，手书;笔迹，字迹 v. 亲手写(handwrite的ing形式) 
handy	[ˈhændi] adj. 方便的 
hang	[hæŋ] vt. 悬挂 vi. 悬垂 n. 悬挂的样子 
happen	[ˈhæpən] vi. 发生 
happiness	['hæpɪnəs, ˈhæpɪnɪs] n. 幸福 
happy	[ˈhæpi] adj. 快乐的 
harbor	['hɑ:bə, ˈhɑrbɚ] n. 海港;海湾 vt.&vi. 心怀;庇护 
hard	[hɑ:d, hɑ:rd] adj. 硬的 adv. 努力地 n. 英〉硬海滩，登陆处 
hard-working	[hɑ:d 'wɜ:kɪŋ, hɑ:rd 'wɜ:rkɪŋ] adj. 勤勉的，努力工作的 
harden	[ˈhɑ:dn, ˈhɑ:rdn] vt. 使硬化;使经得起考验 vi. 变硬或更硬;变稳定 
hardly	[ˈhɑ:dli, ˈhɑ:rdli] adv. 几乎不 
hardship	[ˈhɑ:dʃɪp, ˈhɑ:rdʃɪp] n. 艰难 
hardware	[ˈhɑ:rdwer, ˈhɑ:dweə(r)] n. 五金器具 
hare	[her, heə(r)] n. 野兔;怪人，傻瓜 vt.&vi. 飞跑，疾走 
harm	[hɑ:m, hɑ:rm] n. 危害;伤害 vt. 危害;伤害 
harvest	[ˈhɑ:vɪst, ˈhɑ:rvɪst] n. 收割 vt.&vi. 收割，收成 vt. 收到 
has	[həz, hæz] v. 有( have的第三人称单数 ) 
haste	[heɪst] n. 匆忙，急忙;急速，紧迫 v. 赶紧，匆忙;<古>使快，催促 
hat	[hæt] n. 帽子 vt. 给…戴上帽子，为…提供帽子 vi. 供应帽子 
hatch	[hætʃ] vt.&vi. 孵化 vt. 秘密策划，（尤指）密谋 n. 开口 
hate	[heɪt, het] vt. 厌恶 vi. 恨 n. 强烈的仇恨或厌恶，恨 
have	[həv, hæv] aux. 用以构成完成式及完成式的不定式，表示已经… vt. 有，具有 n. 〈口〉有产者，有钱人 
he	[hi] pron. 他，它;一个人 n. 雄性动物 
head	[hɛd, hed] n. 头部 vt. 用头顶 vi. 朝…行进 adj. 头的 
headache	[ˈhedeɪk, ˈhɛdˌek] n. 头痛 
headmaster	[ˌhedˈmɑ:stə(r), ˌhedˈmæstə(r)] n. （私立学校的）校长 
headquarters	[ˌhedˈkwɔ:təz, ˈhedkwɔ:rtərz] n. 指挥部 
heal	[hi:l] vt. 恢复健康的状态;使恢复正常 vi. 变得完整和健全 
health	[helθ, hɛlθ] n. 卫生 
healthy	[ˈhɛlθi, ˈhelθi] adj. 健康的 
heap	[hip, hi:p] n. 堆，堆积;<口>许多，大量 vt. 扔成一堆;完全填满，灌满 
hear	[hɪr, hɪə(r)] vt.&vi. 听到，听见 vt. 听说 vi. 听 
heart	[hɑ:t, hɑ:rt] n. 心，心脏 vt. 鼓励 vi. 结心 
heat	[hit, hi:t] n. 热，热度，高温;热烈，激烈 vt.&vi. 使温暖，使热;激发…的感情，使兴奋 
heaven	[ˈhɛvən, ˈhevn] n. 天堂 
heavy	[ˈhevi, ˈhɛvi] adj. 重的，沉重的 n. 重物 adv. 密集地 
heel	[hil, hi:l] n. 脚后跟，踵 vt.&vi. （使）倾斜 vt. 给（鞋等）修理后跟 
height	[haɪt] n. 身高 
heighten	[ˈhaɪtn] vt.&vi. （使）变高 
helicopter	[ˈhelɪkɒptə(r), ˈhelɪkɑ:ptə(r)] n. 直升机，直升飞机 vt. 用直升飞机载送 vi. 乘直升飞机 
hell	[hɛl, hel] n. 地狱，阴间 vi. 过放荡生活 int. 该死 
hello	[həˈloʊ, hə'ləʊ] int. 打招呼 n. “喂”的招呼声或问候声 vi. 喊“喂” 
helmet	[ˈhelmɪt, ˈhɛlmɪt] n. 头盔;钢盔 vt. 给…戴上头盔 
help	[help, hɛlp] vt.&vi. 帮助 vt. 治疗 n. 帮助 vi. （在餐桌旁）招待，侍应，作仆人（或店员、服务员等） int. [呼救语]救命！ 
helpful	[ˈhelpfl, ˈhɛlpfəl] adj. 给予帮助的，有益的 
hen	[hen, hɛn] n. 母鸡 
hence	[hɛns, hens] adv. 从此;因此，所以 int. <诗>去 
henceforth	[ˌhensˈfɔ:θ, ˌhensˈfɔ:rθ] adv. 从今以后，今后 
her	[hə(r), hɚ, ɚ,hɚr] pron. (she的宾格)她 
here	[hɪr, hɪə(r)] adv. 在这里 n. 这里 int. 喂 
heritage	[ˈhɛrɪtɪdʒ, ˈherɪtɪdʒ] n. 遗产 
hero	[ˈhɪərəʊ, ˈhɪroʊ] n. 英雄，勇士 
heroic	[həˈrəʊɪk, həˈroʊɪk] adj. 有英雄气概的，英雄的，英勇的;记叙英雄及其事迹的 n. 英雄诗，史诗;英勇行为 
heroin	[ˈherəʊɪn, ˈheroʊɪn] n. 海洛因 
heroine	[ˈherəʊɪn, ˈheroʊɪn] n. 女主角 
hers	[hɜ:z, hɜ:rz] pron. 她的 
herself	[hɜ:ˈself, hɜ:rˈself] pron. （反身代词）她自己 
hesitate	['hezɪteɪt, ˈhezɪteɪt] vi. 犹豫，踌躇;不愿 vt. 对…犹豫;不情愿 
hi	[haɪ] int. （用作问候语）嘿，喂 abbr. 夏威夷群岛的书面缩写;（=high intensity）高强度 
hide	[haɪd] vt. 隐藏 vi. 隐瞒 n. 兽皮 
high	[haɪ] adj. 高的 adv. （程度等）高地 n. 高处，高位 
highly	[ˈhaɪli, 'haɪlɪ] adv. 高度地 
highway	[ˈhaɪweɪ, ˈhaɪˌwe] n. 公路 
hijack	[ˈhaɪˌdʒæk, ˈhaɪdʒæk] vt. 劫持;绑架 n. 劫持;敲诈 
hill	[hɪl] n. 小山，山冈;斜坡 v. 把…堆成小山;培土于…周围 
him	[hɪm] pron. (he的宾格)他 
himself	[hɪmˈself, hɪmˈsɛlf] pron. （反身代词）他自己 
hint	[hɪnt] n. 暗示 vt. 暗示 vi. 暗示，提示 
hire	[haɪr, ˈhaɪə(r)] vt. 雇用 vi. 受雇 n. 租金 
his	[hɪz] pron. (he的所有格)他的;(he的物主代词)他的东西 det. 自己的;属于他的，用于名词前 
historic	[hɪˈstɒrɪk, hɪˈstɔ:rɪk] adj. 在历史上重要的，有历史影响的 
history	[ˈhɪstəri, ˈhɪstri] n. 历史，历史学 
hit	[hɪt] vt.&vi. 打，打击 vt. 击（球） n. 打，打击 vi. （风暴、疾病等）袭击 
hobby	[ˈhɒbi, ˈhɑ:bi] n. 业余爱好 
hold	[həʊld, hoʊld] vt. 拿住，握住 vi. 拿住，握住 n. 握住 
hole	[hoʊl, həʊl] n. 洞，孔 vt.&vi. （在…上）打洞或穿孔 vi. 凿洞 
holiday	[ˈhɑ:lədeɪ, ˈhɒlədeɪ] n. 节日;假日，休息日 vi. 度假，休假 
hollow	[ˈhɒləʊ, ˈhɑ:loʊ] adj. 空洞的 n. 洞，坑 vt.&vi. 挖空（某物），变空 adv. 完全，彻底 
holy	[ˈhəʊli, ˈhoʊli] adj. 神圣的 
home	[həʊm, hoʊm] n. 家 adj. 家庭的 adv. 在家 vi. 回家 vt. 把…送回家 
homework	[ˈhoʊmwɜ:rk, ˈhəʊmwɜ:k] n. 功课 
honest	[ˈɑ:nɪst, ˈɒnɪst] adj. 诚实的 
honesty	[ˈɑ:nəsti, ˈɒnəsti] n. 正直 
honey	[ˈhʌni] n. 蜂蜜 adj. 蜜的 vt. 给…加蜜 
honour	['ɒnə(r), ˈɑnɚ] n. 尊重;荣誉，光荣 vt. 尊敬;以…为荣 
honourable	[ˈɑːnərəbl, ˈɒnərəbl] adj. 尊敬的 
hook	[hʊk] n. 钩，铁钩 vt.&vi. 用钩挂 vt. 钩，钩住 vi. 弯成钩状 
hope	[hoʊp, həʊp] n. 希望，期望 vt.&vi. 希望，期望 vt. [俚语]相信，认为 vi. 希望，盼望，期待 
hopeful	[ˈhoʊpfl, ˈhəʊpfl] adj. 抱有希望的;给人以希望的 n. 有成功希望的人 
hopeless	[ˈhəʊpləs, ˈhoʊpləs] adj. 不可救药的 
horizon	[həˈraɪzn] n. 地平线 
horn	[hɔ:n, hɔ:rn] n. 角质;角，触角 vi. 不请自来;闯入 
horrible	[ˈhɔ:rəbl, ˈhɒrəbl] adj. 可怕的 
horse	[hɔ:s, hɔ:rs] n. 马 vt. 为…备马 vi. 欲交配，，用于母马 adj. 马的 
horsepower	[ˈhɔ:spaʊə(r), ˈhɔ:rspaʊə(r)] n. <物>马力 
hose	[həʊz, hoʊz] n. 软管，胶皮管;长筒袜 vt. 用软管浇;痛打 
hospital	[ˈhɒspɪtl, ˈhɑ:spɪtl] n. 医院 
hospitality	[ˌhɑ:spɪˈtæləti, ˌhɒspɪˈtæləti] n. 殷勤好客 
host	[hoʊst, həʊst] n. [计算机]主机 vt. 当主人 vi. 做主人，做东道主 
hostage	[ˈhɒstɪdʒ, ˈhɑ:stɪdʒ] n. 人质 
hostess	[ˈhoʊstəs, ˈhəʊstəs] n. 女主人;（夜总会的）女招待 vt. 作东，请客 
hostile	[ˈhɒstaɪl, ˈhɑ:stl] adj. 怀有敌意的;敌人的，敌对的 n. 敌方;敌对者，敌对物 
hot	[hɒt, hɑ:t] adj. 热的 vt. 使兴奋，使激动 adv. 热的 vi. 变热 
hotel	[həʊˈtel, hoʊˈtel] n. 旅馆，宾馆，酒店，饭店 vt. 使…在饭店下榻 vi. 进行旅馆式办公 
hour	[aʊr, ˈaʊə(r)] n. 小时，钟头 
house	[haʊs] n. 房屋;全家人 v. 给…提供住房;收藏 
household	[ˈhaʊshəʊld, ˈhaʊshoʊld] n. 家庭;家庭，户 adj. 家喻户晓的;家庭的，家内的，一家的 
housewife	[ˈhaʊswaɪf, ˈhaʊsˌwaɪf] n. 家庭主妇 
housework	[ˈhaʊswɜ:k, ˈhaʊswɜ:rk] n. 家务劳动 
how	[haʊ] adv. 怎样;健康状况如何 n. 方式;方法 
however	[haʊˈevə(r), haʊˈevɚ] adv. 然而;可是 conj. 不管怎样 
huge	[hju:dʒ, hjudʒ] adj. 巨大的 
human	[ˈhju:mən, ˈhjumən] n. 人，人类 adj. 人的;有人性的 
humble	[ˈhʌmbl, ˈhʌmbəl] adj. 谦逊的;简陋的 vt. 使谦恭;轻松打败（尤指强大的对手） 
humidity	[hju:ˈmɪdəti, hjuˈmɪdɪti] n. （空气中的）湿度 
humorous	[ˈhju:mərəs, ˈhjumərəs] adj. 幽默的 
humour	[ˈhju:mə(r), ˈhjumɚ] n. 幽默;幽默感  v. 迁就;顺应 
hundred	[ˈhʌndrɪd, ˈhʌndrəd] num. 一百 n. 一百 adj. 一百的 
hunger	[ˈhʌŋgə(r), ˈhʌŋɡɚ] n. 饿，饥饿 vt.&vi. （使）饥饿 vi. 渴望 
hungry	[ˈhʌŋɡri, ˈhʌŋgri] adj. 饥饿的 
hunt	[hʌnt] vt.&vi. 打猎 vt. 打猎 vi. 寻找 n. 打猎 
hurry	[ˈhʌri, ˈhɜ:ri] vt.&vi. 仓促（做某事）;催促 n. 匆忙，急忙 
hurt	[hɜ:rt, hɜ:t] vt. 损害 vi. 疼痛 n. 伤害 adj. 受伤的 
husband	[ˈhʌzbənd] n. 丈夫;〈英〉管家 vt. 节俭地使用;〈罕〉做…的丈夫 
ice	[aɪs] n. 冰 vt.&vi. （使）结冰 vt. 结冰 vi. 结冰 adj. 冰的 
idea	[aɪˈdɪə, aɪˈdi:ə] n. 主意，想法 
ideal	[aɪˈdi:əl, aɪˈdiəl, aɪˈdil] adj. 理想的，完美的;被认为是最好的 n. 理想;典范，典型 
identical	[aɪˈdentɪkl, aɪˈdɛntɪkəl] adj. 同一的;完全同样的，相同的 n. 完全相同的事物;同卵双胞 
identify	[aɪˈdɛntəˌfaɪ, aɪˈdentɪfaɪ] vt. 确定;识别，认出 vi. 确定;认同 
idle	[ˈaɪdl] adj. 空闲的 vi. 空转 vt. 虚度 n. （尤指暂时地）关闭工厂，使（工人）闲着 
if	[ɪf] conj. 即使;如果，倘若 n. 条件，设想 
ignorance	[ˈɪɡnərəns, ˈɪgnərəns] n. 无知，愚昧 
ignorant	[ˈɪgnərənt, ˈɪɡnərənt] adj. 无知的，愚昧的 
ignore	[ɪgˈnɔ:(r), ɪɡˈnɔr, -ˈnor] vt. 忽视，不顾 
ill	[ɪl] adj. 不好的 adv. 坏 n. 伤害 
illegal	[ɪˈli:gl, ɪˈliɡəl] adj. 不合法的，违法的;违反规则的 n. 非法移民，非法劳工;间谍 
illness	[ˈɪlnəs, ˈɪlnɪs] n. 疾病 
illustration	[ˌɪləˈstreɪʃn, ˌɪləˈstreʃən] n. 插图 
image	[ˈɪmɪdʒ] n. 影像;肖像 vt. 反映;想像 
imagination	[ɪˌmædʒɪˈneɪʃn, ɪˌmædʒəˈneʃən] n. 想像，想像力 
imagine	[ɪˈmædʒɪn] vt. 想像;想，设想 vi. 想象;猜想，推测 
imitation	[ˌɪmɪˈteɪʃn, ˌɪmɪˈteʃən] n. 仿制品;模仿，仿效 adj. 仿制的;人造的 
immediate	[ɪˈmi:diət, ɪˈmidiɪt] adj. 立即的 
immense	[ɪˈmens, ɪˈmɛns] adj. 极大的，巨大的 
immerse	[ɪˈmɜ:s, ɪˈmɜ:rs] vt. 浸没 
immigrant	[ˈɪmɪgrənt, ˈɪmɪɡrənt] n. 移民，侨民;从异地移入的动物[植物] adj. 移民的，移来的;侨民的 
impact	[ˈɪmpækt, ˈɪmˌpækt] n. 影响 vt. 撞击 vi. 产生影响 
impartial	[ɪmˈpɑ:ʃl, ɪmˈpɑ:rʃl] adj. 不偏不倚的 
impatient	[ɪmˈpeɪʃnt, ɪmˈpeʃənt] adj. 不耐烦的 
implement	[ˈɪmplɪment, ˈɪmpləmənt] vt. 实施，执行;使生效，实现 n. 工具，器械;家具 
imply	[ɪmˈplaɪ] vt.&vi. 暗示 
import	[ˈɪmpɔ:t, ˈɪmpɔ:rt] n. 输入 vt. 输入，进口 vi. 具重要性 
importance	[ɪmˈpɔ:rtns, ɪmˈpɔ:tns] n. 重要性 
important	[ɪmˈpɔ:rtnt, ɪmˈpɔ:tnt] adj. 重要的 
impossible	[ɪmˈpɒsəbl, ɪmˈpɑ:səbl] adj. 不可能的，做不到的;难以忍受的 n. 不可能;不可能的事 
impress	[ɪmˈpres, ɪmˈprɛs] vt. 印;给…以深刻印象 n. 印象;印记 
impression	[ɪmˈprɛʃən, ɪmˈpreʃn] n. 印象，感觉 
improve	[ɪmˈpru:v, ɪmˈpruv] vt. 提高（土地、地产）的价值;利用（机会） vi. 变得更好;改进，改善 
in	[ɪn] prep. 采用（某种方式） adv. 在家 adj. 在内的，朝内的 n. 执政党，掌权者 
inch	[ɪntʃ] n. 英寸（相当于 2。54 厘米，一英尺有12英寸） vt. 使缓慢地移动 vi. 缓慢移动 
incident	[ ˈɪnsɪdənt, ˈɪnsɪdənt] n. 事件，事变;小插曲 adj. [法]附带的;[光]入射的 
incline	[ɪnˈklaɪn] vt.&vi. （使）倾斜，弄斜;（使）偏向，倾向于 n. 倾斜;斜面 
include	[ɪnˈklu:d, ɪnˈklud] vt. 包括 
income	[ˈɪnˌkʌm, ˈɪnkʌm] n. 收入，进款 
increase	[ɪnˈkri:s, ɪnˈkris] vt.&vi. 增加，增大，增多 vt. 增强，增进 vi. 增强 
incredible	[ɪnˈkredəbl, ɪnˈkrɛdəbəl] adj. 难以置信的 
indeed	[ɪnˈdid, ɪnˈdi:d] adv. 甚至 
independence	[ˌɪndɪˈpendəns, ˌɪndɪˈpɛndəns] n. 独立，自主 
independent	[ˌɪndɪˈpɛndənt, ˌɪndɪˈpendənt] adj. 自主的;不相关连的 n. 独立自主的人;无党派人士 
India	['ɪndɪə, ˈɪndɪə] n. 印度（亚洲） 
Indian	[ˈɪndiən] adj. 印度的;印第安人的 n. 印第安人;印度人 
indicate	[ˈɪndɪˌket, ˈɪndɪkeɪt] vt. 表明，标示，指示 
indication	[ˌɪndɪˈkeɪʃn, ˌɪndɪˈkeʃən] n. 指示 
individual	[ˌɪndɪˈvɪdʒuəl, ˌɪndəˈvɪdʒuəl] adj. 个人的;个别的 n. 个人;个体 
indoor	[ˈɪnˌdɔr, -ˌdor, ˈɪndɔ:(r)] adj. 室内的，户内的 
indoors	[ˌɪnˈdɔ:z, ˌɪnˈdɔ:rz] adv. 在屋里 
industrial	[ɪnˈdʌstriəl] adj. 工业的，产业的;从事工业的 n. 工业股票;工业工人 
industry	[ˈɪndəstri] n. 工业 
inevitable	[ɪnˈɛvɪtəbəl, ɪnˈevɪtəbl] adj. 不可避免的 
infant	[ˈɪnfənt, 'ɪnfənt] n. 婴儿，幼儿;未成年人 adj. 婴儿的，幼儿的;幼稚的，幼小的 
infinite	[ˈɪnfɪnət, ˈɪnfənɪt] adj. 无限的，无穷的;无数的，许许多多的 n. 无限，无穷;[数] 无穷大 
inflation	[ɪnˈfleʃən, ɪnˈfleɪʃn] n. 通货膨胀 
influence	[ˈɪnfluəns,  ˈɪnfluəns] n. 影响;势力 vt. 影响;感染 
inform	[ɪnˈfɔ:rm, ɪnˈfɔ:m] vt. 通知;使活跃，使充满 vi. 通知;告发 
information	[ˌɪnfəˈmeɪʃn, ˌɪnfərˈmeɪʃn] n. 消息 
infra-red	['ɪnfrər'ed] adj. 红外线的 
inhabitant	[ɪnˈhæbɪtənt] n. 居民，住户 
inherent	[ɪnˈhɪərənt, ɪnˈhɪrənt] adj. 天生 
initial	[ɪˈnɪʃl, ɪˈnɪʃəl] adj. 最初的 n. 首字母 vt. 用姓名的首字母签名 
injure	[ˈɪndʒə(r), ˈɪndʒɚ] vt. 损害，毁坏 
injury	[ˈɪndʒəri] n. 伤害，损害 
ink	[ɪŋk] n. 墨水，油墨;（乌贼分泌的）墨液 vt. 给…上油墨（以供印刷、签订合同等）;签名（在…上） 
inn	[ɪn] n. 小旅馆，客栈;小饭店，小酒馆 vi. 住旅馆 
inner	[ˈɪnə(r), ˈɪnɚ] adj. 内部的，内心的;精神的 n. 内部，里面;射中接近靶心部分的一发 
innocent	[ˈɪnəsnt, ˈɪnəsənt] adj. 清白的;天真无邪的 n. 无辜者;头脑简单的人 
inquire	[ɪn'kwaɪə(r), ɪnˈkwaɪr] vt.&vi. 打听，询问 
insect	[ˈɪnsekt, ˈɪnˌsɛkt] n. 虫，昆虫;卑鄙的人 adj. 昆虫的;卑劣的 
inside	[ˌɪnˈsaɪd, ɪnˈsaɪd, ˈɪnˌsaɪd] adj. 里面的，内部的 n. 里面，内侧 adv. 在内地，在内部地 prep. 在…以内 
insight	[ˈɪnˌsaɪt, ˈɪnsaɪt] n. 顿悟 
insist	[ɪnˈsɪst] vt.&vi. 坚持 
inspect	[ɪnˈspɛkt, ɪnˈspekt] vt. 视察;检查，检验 vi. 进行检查;进行视察 
inspire	[ɪnˈspaɪə(r), ɪnˈspaɪr] vt. 激励;鼓舞 vi. 吸，吸入 
instance	[ˈɪnstəns] n. 情况;例子，实例 vt. 举…为例 
instant	[ˈɪnstənt] n. 瞬间，顷刻;此刻 adj. 立即的;迫切的 
instead	[ɪnˈstɛd, ɪnˈsted] adv. 反而 
instinct	[ˈɪnˌstɪŋkt, ˈɪnstɪŋkt] n. 本能，天性;冲动 adj. 深深地充满着 
institute	[ˈɪnstɪtju:t, ˈɪnstɪtu:t] vt. 建立;制定 n. 学院;协会 
institution	[ˌɪnstɪˈtju:ʃn, ˌɪnstɪˈtu:ʃn] n. （大学、银行等规模大的）机构 
instruct	[ɪnˈstrʌkt] vt. 通知 
instruction	[ɪnˈstrʌkʃn, ɪnˈstrʌkʃən] n. 授课 
instructor	[ɪnˈstrʌktɚ, ɪnˈstrʌktə(r)] n. 指导者，教师 
instrument	[ˈɪnstrəmənt] n. 仪器;乐器 vt. 用仪器装备;为演奏谱曲 
insurance	[ɪnˈʃʊərəns, ɪnˈʃʊrəns] n. 保险费;保险，保险业 adj. [体]巩固球队领先局面，使对手不能因增加一分而成平局的 
intelligence	[ɪnˈtɛlədʒəns, ɪnˈtelɪdʒəns] n. 情报 
intend	[ɪnˈtend, ɪnˈtɛnd] vt. 意欲，计划;为特殊目的而设计 vi. 怀有某种意图或目的 
intention	[ɪnˈtenʃn, ɪnˈtɛnʃən] n. 意向 
interest	[ˈɪntrəst, ˈɪntrɪst, -tərɪst, -ˌtrɛst] n. 利息;兴趣，爱好 vt. 使产生兴趣;使参与，使加入 
interested	[ˈɪntrəstɪd, ˈɪntrɪstɪd, -tərɪstɪd, -təˌrɛstɪd] adj. 感兴趣的;拥有权益的 v. 使…感兴趣(interest的过去分词) 
interesting	[ˈɪntrɪstɪŋ, ˈɪntrəstɪŋ] adj. 有趣的 
interfere	[ˌɪntəˈfɪə(r), ˌɪntərˈfɪr] vi. 干预，干涉 
interior	[ɪnˈtɪəriə(r), ɪnˈtɪriə(r)] n. 内部;内政 adj. 内部的;内地的，国内的 
international	[ˌɪntərˈnæʃnəl, ˌɪntəˈnæʃnəl] adj. 国际的;两国（或以上）国家的 n. 国际组织;国际体育比赛 
Internet	[ˈɪntərnet, ˈɪntənet] n. 国际互联网，因特网 
interpreter	[ɪnˈtɜ:rprɪtə(r), ɪnˈtɜ:prɪtə(r)] n. 解释者 
interrupt	[ˌɪntəˈrʌpt] vt.&vi. 打断（别人的话等） vt. 中断 vi. 打断 n. 中断 
interval	[ˈɪntəvl, ˈɪntərvl] n. 间隔 
interview	[ˈɪntəvju:, ˈɪntərvju:] n. 采访 vt.&vi. 面试 vt. 采访 
intimate	[ˈɪntɪmət, ˈɪntəmɪt] adj. 亲密的，亲近的 n. 至交 v. 暗示，提示 
into	[ˈɪntə, ˈɪntu] prep. （表示方向）进入…中 
introduce	[ˌɪntrəˈdju:s, ˌɪntrəˈdu:s] vt. 介绍 
invade	[ɪnˈveɪd, ɪnˈved] vt.&vi. 侵入，侵略;进行侵略 vt. 侵犯;侵袭 
invasion	[ɪnˈveʒən, ɪnˈveɪʒn] n. 侵袭 
invent	[ɪnˈvent, ɪnˈvɛnt] vt. 虚构 
invention	[ɪnˈvɛnʃən, ɪnˈvenʃn] n. 发明 
invest	[ɪnˈvest, ɪnˈvɛst] vt.&vi. 投资;花费 vt. 授予，使就职;给…穿衣，装饰 
investigate	[ɪnˈvestɪgeɪt, ɪnˈvɛstɪˌɡet] vt. 调查;研究 vi. 作调查 
investment	[ɪnˈvɛstmənt, ɪnˈvestmənt] n. 投资，投资额 
invitation	[ˌɪnvɪˈteɪʃn, ˌɪnvɪˈteʃən] n. 招待，邀请 
invite	[ɪnˈvaɪt] vt. 邀请;招致 n. 邀请 
involve	[ɪnˈvɒlv, ɪnˈvɑ:lv] vt. 包含 
iron	[ˈaɪən, ˈaɪərn] n. 铁器，铁制品 adj. 铁制的，含铁的 vt. 熨烫 vi. 熨衣 
irregular	[ɪˈregjələ(r), ɪˈrɛɡjəlɚ] adj. 不规则的，不对称的;无规律的 n. 非正规军军人;不规则物 
is	[ɪz] vt.&vi. 是（be的三单形式 n. 存在 
island	[ˈaɪlənd] n. 岛，岛屿 vt. 使孤立 
isolate	[ˈaɪsəleɪt, ˈaɪsəˌlet] vt. 使隔离，使孤立 vi. 隔离，孤立 n. [微]分离菌 adj. 孤立的 
issue	[ˈɪʃu:, ˈɪʃu] n. 问题 vt. 发行 vi. 发行 
it	[ɪt] pron. 它;他 n. <美俚>傻瓜，笨蛋;<俚>绝妙的人 
Italian	[ɪ'tælɪən, ɪˈtæljən] n. 意大利语;意大利人 adj. 意大利的;意大利语的 
Italy	['ɪtəlɪ] n. 意大利（欧洲） 
item	[ˈaɪtəm] n. 项目;条，条款 adv. 又，同上 
its	[ɪts] pron. (it的所有格形式)它的 
itself	[ɪtˈself, ɪtˈsɛlf] pron. (it的反身形式) 
jacket	[ˈdʒækɪt] n. 短上衣，夹克;土豆皮 vt. 给…穿夹克;给…装护套 
jail	[dʒel, dʒeɪl] n. 监狱;拘留所 vt. 监禁;拘留 
jam	[dʒæm] n. 果酱 vt. 把…挤进 vi. 堵塞 
January	[ˈdʒænjueri, ˈdʒænjuəri] n. 一月 
Japan	[dʒə'pæn, dʒəˈpæn] n. 日本 
Japanese	[ˌdʒæpə'ni:z, ˌdʒæpəˈniz, -ˈnis] n. 日语;日本人，日本国民 adj. 日语的;日本的，日本人的 
jar	[dʒɑr, dʒɑ:(r)] n. 罐子 vi. 发出刺耳的声音 vt. 使震动 
jaw	[dʒɔ:, dʒɔ] n. 下巴;颌 vi. 闲谈;唠唠叨叨，喋喋不休 
jealous	[ˈdʒɛləs, ˈdʒeləs] adj. 妒忌的 
jet	[dʒɛt, dʒet] n. 喷气式飞机 vi. 乘喷气式飞机 adj. 黑玉制的或黑玉似的 vt. 喷射，喷出 
jewel	[ˈdʒu:əl, ˈdʒuəl] n. 宝石，宝石饰物 
jewelry	['dʒu:əlrɪ, ˈdʒuəlri] n. <美>珠宝，首饰 
job	[dʒɒb, dʒɑ:b] n. 职业 vt. 承包 vi. 做零工 
join	[dʒɔɪn] vt.&vi. 加入 vt. 参与 n. 连接 
joint	[dʒɔɪnt] adj. 共同的，联合的 n. [解]关节 vt. 结合，联合 
joke	[dʒoʊk, dʒəʊk] n. 笑话，玩笑;笑柄，笑料 vt.&vi. 开玩笑;戏弄 
journal	[ˈdʒɜ:rnl, ˈdʒɜ:nl] n. 日报，日志，日记 
journalist	[ˈdʒɜ:nəlɪst, ˈdʒɜ:rnəlɪst] n. 新闻工作者，新闻记者 
journey	[ˈdʒɜ:rni, ˈdʒɜ:ni] n. 旅行，旅程行期 vi. 旅行，出游 vt. 在…旅行或旅行到过… 
joy	[dʒɔɪ] n. 喜悦，快乐，高兴 vi. 因…而高兴 vt. 高兴，使快乐 
judge	[dʒʌdʒ] vt.&vi. 审判，评判 vt. 评价 n. 法官 
judgment	['dʒʌdʒmənt, ˈdʒʌdʒmənt] n. 判断，鉴定 
juice	[dʒu:s, dʒus] n. 果汁 
July	[dʒuˈlaɪ, dʒʊˈlaɪ] n. 七月 
jump	[dʒʌmp] vt. 跳 vi. 跳跃 n. 猛长，暴涨 
junction	[ˈdʒʌŋkʃn, ˈdʒʌŋkʃən] n. 连接，接合 
June	[dʒu:n] n. 六月 
junior	[ˈdʒu:niə(r), ˈdʒunjɚ] adj. 较年幼的，较年小的;三年级的，低年级的 n. 年少者，青少年;晚辈 
just	[dʒʌst] adv. 正好;刚才 adj. 公正的，合理的;恰当的 
justice	[ˈdʒʌstɪs] n. 正义 
justify	[ˈdʒʌstɪfaɪ, ˈdʒʌstəˌfaɪ] vt. 证明…有理;为…辩护 vi. 整理版面;证明合法 
keen	[ki:n, kin] adj. 锐利的 vi. （为死者）恸哭，哀号 n. 〈英〉号哭，恸哭 
keep	[ki:p, kip] vt. 保持 vi. （食品）保持新 n. 保持，保养 
kettle	[ˈketl, ˈkɛtl] n. （烧水用的）壶 
key	[ki:, ki] n. 钥匙 vt. 键入 vi. 使用钥匙 adj. 关键的 
keyboard	[ˈki:bɔ:rd, ˈki:bɔ:d] n. 键盘 vt. 用键盘输入 vi. 用键盘进行操作 
kick	[kɪk] vt.&vi. 踢 n. （毒品或酒精的）效力 vi. 踢蹬，踢（腿） vt. （因干了蠢事、失去良机等）对（自己）生气 
kid	[kɪd] n. <口>小孩 vt.&vi. 欺骗，戏弄，取笑 adj. 较年幼的 
kill	[kɪl] vt.&vi. 杀死… vt. 使停止[结束，失败] n. 杀死 adj. 致命的 
kilo	[ˈki:loʊ, ˈki:ləʊ] n. 千克 
kilogramme	['kɪləʊgræm, 'kɪləˌgræm] n. 公斤 
kilometer	[kɪˈlɑmɪtɚ, ˈkɪləˌmitɚ, 'kɪləˌmi:tə] n. <美>千米，公里 
kind	[kaɪnd] n. 〈古〉方式，方法;本质，天性 adj. 仁慈的，体贴的;友善的，好心的 
kindergarten	[ˈkɪndəgɑ:tn, ˈkɪndərgɑ:rtn] n. 幼儿园，学前班 
kindness	[ˈkaɪndnəs, ˈkaɪndnɪs] n. 仁慈，善行 
king	[kɪŋ] n. 国王 vt. 立…为王 adj. 巨型的 
kingdom	[ˈkɪŋdəm] n. 王国 
kiss	[kɪs] vt. 接吻 vi. 接吻 n. 吻 
kitchen	[ˈkɪtʃɪn, ˈkɪtʃən] n. 厨房 
kite	[kaɪt] n. 风筝 vt. 涂改（支票） vi. 使用空头支票 
knee	[ni:, ni] n. 膝;膝盖 vt. 用膝盖碰 
kneel	[nil, ni:l] vi. 跪，下跪 
knife	[naɪf] n. 刀 vt. 切割，刺 vi. 劈开 
knock	[nɒk, nɑ:k] n. 短促的敲打（声） vi. 猛烈敲击 vt. （心）怦怦跳 
know	[noʊ, nəʊ] v. 知道;了解 n. 知情 
knowledge	[ˈnɑ:lɪdʒ, ˈnɒlɪdʒ] n. 了解，理解 
lab	[læb] n. 实验室，研究室 
label	[ˈleɪbl] n. 标签;称标记，符号 vt. 贴标签于;把…称为 
labor	['leɪbə(r), ˈlebɚ] n. 劳动 v. 努力争取(for) adj. 劳工的，工会的 vi. （指引擎）缓慢而困难地运转 
laboratory	[ləˈbɒrətri, ˈlæbrətɔ:ri] n. 实验室 
lace	[leɪs, les] n. 蕾丝 vt. 给（书、讲话等）润色 vi. 以系带系紧 
lack	[læk] vt. 缺乏，缺少;需要的东西 n. 缺乏，不足，没有;缺少的东西 
lad	[læd] n. 少年，小伙子 
ladder	[ˈlædɚ, ˈlædə(r)] n. 梯子，阶梯;梯状物 vi. 使（袜子）发生抽丝现象;像长筒袜一样抽丝 
lady	[ˈleɪdi, ˈledi] n. （指成年女子，有些人尤其是长者认为这样说比较礼貌）女士 
lake	[leɪk, lek] n. 湖;深红色颜料 vt.&vi. 血球溶解;使（血液）发生血球溶解 
lamb	[læm] n. 羔羊肉;羔羊，小羊 vi. 生小羊，产羊羔 
lamp	[læmp] n. 灯 
land	[lænd] n. 土地 vt.&vi. （使）登岸 vt. 自船上卸下 vi. 跳落，跌落，被抛落（地面） 
landing	[ˈlændɪŋ] n. 登陆，着陆;终点 v. （使）登陆(land的现在分词) 
landlady	[ˈlændleɪdi, ˈlændˌledi] n. 女房东 
landlord	[ˈlændlɔ:d, ˈlændlɔ:rd] n. 店主 
lane	[len, leɪn] n. 车道 
language	[ˈlæŋgwɪdʒ, ˈlæŋɡwɪdʒ] n. 语言，语言文字 
large	[lɑ:rdʒ, lɑ:dʒ] adv. 大大地 adj. 大的 v. 玩个痛快 
laser	[ˈlezɚ, ˈleɪzə(r)] n. 激光 
last	[lɑ:st, læst] n. 最后 vt. 经受住 adj. 最后的 vi. 持续 adv. 最后 
late	[leɪt, let] adj. 已故的;晚的，迟到的 adv. 晚，迟;后期地 
lately	[ˈletli, ˈleɪtli] adv. 近来，最近 
later	[ˈleɪtə(r), ˈletɚ] adv. 后来;随后 adj. 以后的;后来的 
Latin	[ˈlætɪn, ˈlætn] n. 拉丁文;拉丁语，拉丁文学 adj. 拉丁美洲的;拉丁的，拉丁语的 
latter	[ˈlætə(r), ˈlætɚ] adj. 后者的 
laugh	[lɑ:f, læf] vi. 笑 vt. 以笑表示，以笑感动[影响] n. 笑 
launch	[lɔ:ntʃ, lɔntʃ, lɑntʃ] vt. 发射 vi. 投入 n. 投掷 
laundry	[ˈlɔ:ndri, ˈlɔndri, ˈlɑn-] n. 洗衣店，洗衣房 
lavatory	[ˈlævətri, ˈlævətɔ:ri] n. 厕所 
law	[lɔ, lɔ:] n. 法 vt.&vi. [口语、方言]诉诸法律，对…起诉，控告 vt. 控告 
lawyer	[ˈlɔ:jə(r), ˈlɔjɚ] n. 律师，法学家 
lay	[leɪ, le] vt. 放置 adj. 世俗的 n. 叙事诗 
layer	[ˈler, ˈleɪə(r)] n. 层，层次 vt. 把…分层堆放 vi. 形成或分成层次 
lazy	[ˈlezi, ˈleɪzi] adj. 懒惰的 
lead	[li:d] vt. 领导 vi. 导致 n. 铅 adj. 领头的 
leader	[ˈli:də(r), ˈlidɚ] n. 领袖，领导者 
leaf	[lif, li:f] n. 叶子 vt.&vi. 翻书（报） vi. 生叶 
league	[li:g, liɡ] n. 联盟;社团 vt.&vi. 使…结盟，使…结合 
lean	[lin, li:n] vt.&vi. （使）倾斜，屈身 vt. 倚 adj. 瘦的 n. 瘦肉 vi. 倾向于（某种观点、意见或态度等）（与to 或 toward连用） 
leap	[li:p, lip] vi. 跳 vt. 跳过，跃过 n. 跳跃，飞跃 
learn	[lɜ:n, lɜ:rn] vt.&vi. 得知 vt. 学习 vi. 学习 
least	[li:st, list] adj. 最小的 adv. 最少，最小 n. 最小 
leather	[ˈleðə(r), ˈlɛðɚ] n. 皮革制品 vt. 用皮革包盖 adj. 皮的，皮革的，皮革制的 
leave	[liv, li:v] vt. 离开 vt.&vi. 离去 n. 准假 
lecture	[ˈlektʃə(r), ˈlɛktʃɚ] n. 演讲 vi. 作演讲 vt. 给…作演讲 
left	[lɛft, left] adj. 左边的，左侧的 n. 左，左面 adv. 向左 v. 离开( leave的过去式和过去分词) 
leg	[leg, lɛɡ] n. 腿;支柱，支架 vi. <口>走，跑 
legal	[ˈliɡəl, ˈli:gl] adj. 法律的;合法的 n. 法定权利;依法必须登报的声明 
leisure	[ˈleʒə(r), ˈli:ʒər] n. 闲暇;悠闲 adj. 闲暇的;空闲的 
lemon	[ˈlemən, ˈlɛmən] n. 柠檬;柠檬黄 adj. 柠檬色的 
lend	[lɛnd, lend] vt. 把…借给;贷（款） vi. 增加;增添 
length	[leŋθ] n. 长度，长 
less	[lɛs, les] adj. 较小的 adv. 较少地，较小地 prep. 减去 n. 较少，较小 
lesson	[ˈlesn, ˈlɛsən] n. 功课;教训，训诫 vt. 教训，训斥;教课 
lest	[lest, lɛst] conj. 以免 
let	[lɛt, let]  允许，任由 
letter	[ˈletə(r), ˈlɛtɚ] n. 信 vt. 用字母标明 vi. 写印刷体字母 
level	[ˈlɛvəl, ˈlevl] n. 水平，水准 adj. 水平的 vt. 使同等 vi. 拉平 vi. 瞄准 
liberate	[ˈlɪbəˌret, ˈlɪbəreɪt] vt. 解放 
liberty	[ˈlɪbəti, ˈlɪbərti] n. 自由 
librarian	[laɪˈbreəriən, laɪ'brerɪrn] n. 图书管理员 
library	[ˈlaɪbreri, ˈlaɪbrəri] n. 藏书 
license	[ˈlaɪsəns, ˈlaɪsns] n. 许可证，执照;特许 vt. 同意;发许可证 
lid	[lɪd] n. 盖子;限制 vt. 给…盖盖子 
lie	[laɪ, lai] v. 躺;说谎 n. 谎言;谎话 
life	[laɪf] n. 生活，生计 
lifetime	[ˈlaɪftaɪm, ˈlaɪfˌtaɪm] n. 有生之年;一生，寿命 na. 终生;终身保障 
lift	[lɪft] vt.&vi. 举起，抬起 vt. 提升 vi. 消散 n. 电梯 
light	[laɪt] n. 光 adj. 轻的 v. 点燃 adv. 轻地，轻装地 
lighten	[ˈlaɪtn, ˈlaɪtn:] vt. 使（某物）更明亮 vi. 减轻;点亮 
lightly	[ˈlaɪtli] adv. 轻轻地，轻巧地 
lightning	[ˈlaɪtnɪŋ] adj. 闪电般的，快速的 n. 闪电，雷电 vi. 打闪 
like	[laɪk] vt. 喜欢 prep. （表示属性）像 adj. 相似的 n. 相类似的人[事物] conj. 如同 adv. 如 
likely	[ˈlaɪkli] adj. 可能的;适合的 adv. 可能;或许 
likewise	[ˈlaɪkwaɪz, ˈlaɪkˌwaɪz] adv. 同样地 
limb	[lɪm] n. 枝干;肢，翼 vt. 割断…的四肢，肢解;砍树枝 
limit	[ˈlɪmɪt] n. 限制;界限 vt. 限制，限定 
line	[laɪn] n. 线条 vt. 排队 vi. 形成一层 
linen	[ˈlɪnən, ˈlɪnɪn] n. 亚麻布，亚麻线;家庭日用织品 adj. 亚麻的，亚麻布制的 
liner	[ˈlaɪnɚ, ˈlaɪnə(r)] n. 衬里 
link	[lɪŋk] n. 环，节 vt. 连结 vi. 用环连接 
lion	[ˈlaɪən] n. 狮子 
lip	[lɪp] n. 嘴唇 adj. 唇的 vt. 用嘴唇接触 
liquid	[ˈlɪkwɪd] n. 液体;流音 adj. 液体的;清澈的 
list	[lɪst] n. 清单，目录 vt. 列出，列入 vi. 列于表上 
listen	[ˈlɪsən, ˈlɪsn] vi. 倾听;留心听 n. 听，倾听 
liter	['li:tə(r), ˈlitɚ] n. [计量] 公升（容量单位） 
literary	[ˈlɪtəreri, ˈlɪtərəri] adj. 文学（上）的 
literature	[ˈlɪtərəˌtʃʊr, -tʃɚ, ˈlɪtrətʃə(r)] n. 文学 
little	[ˈlɪtl] adj. 小的 adv. 不多，略微 n. （表示否定）微少 det. （数量上）微少的，少到几乎没有的 
live	[lɪv] vi. 居住;生存 vt. 经历;度过 
lively	[ˈlaɪvli] adj. 活泼的;充满活力的 adv. 轻快地：轻快地，富有活力地;轻快地跳起 
liver	[ˈlɪvɚ, ˈlɪvə(r)] n. 肝脏;（食用）肝 adj. 肝味的;深赤褐色的 
living-room	['lɪvɪŋ'ru:m] n. 客厅，起居室 
load	[ləʊd, loʊd] n. 负荷 vt. 使担负 vi. 加载 
loaf	[loʊf, ləʊf] n. 一条（块）面包 v. 游荡;游手好闲 
loan	[loʊn, ləʊn] n. 贷款 vt. 借，借给 vi. 借出 
lobby	[ˈlɒbi, ˈlɑ:bi] n. 休息室 vi. 为了支持或抵制某项特定目标游说 vt. 对…进行游说 
local	[ˈloʊkl, ˈləʊkl] adj. 局部的;地方的 n. 慢车;本地居民（律师、教士、医生） 
locate	[ləʊˈkeɪt, ˈloʊkeɪt] vt. 位于;说出来源 vi. 定位;定居 
location	[ləʊˈkeɪʃn, loʊˈkeɪʃn] n. 定位 
lock	[lɒk, lɑ:k] n. 锁 vt. 锁上 vi. 卡住，不动 
lodge	[lɒdʒ, lɑ:dʒ] vi. 存放 vt. 提出（报告、要求、申诉等） n. <古>小屋，草屋 
lodging	[ˈlɑ:dʒɪŋ, ˈlɒdʒɪŋ] n. 寄宿;出租的房间 v. 存放（ lodge的现在分词）;暂住 
log	[lɒg, lɔ:g] n. 日志;记录 v. 伐木;把…载入正式记录 
logical	[ˈlɑ:dʒɪkl, ˈlɒdʒɪkl] adj. 符合逻辑的 
lonely	[ˈləʊnli, ˈloʊnli] adj. 寂寞的 
long	[lɒŋ, lɔ:ŋ] adj. 长的 adv. 长久地 n. 长时间，长时期 vi. 渴望，极想 
look	[lʊk] vt.&vi. 看，瞧 vi. 寻找 n. 看 int. （插话或唤起注意）喂，听我说 
loose	[lu:s, lus] adj. 松的，宽的 vt. 松开 vi. 变得松散 adv. 散漫地 n. 解放 
lord	[lɔ:rd, lɔ:d] n. 主;上帝 vi. 逞威风 
lorry	[ˈlɔ:ri, ˈlɒri] n. 运货汽车，机动卡车 
lose	[luz, lu:z] vt. 失去;错过 vi. 损失;输掉 
loss	[lɒs, lɔ:s] n. 损失，减少 
lot	[lɑ:t, lɒt] n. 许多 adv. （与形容词和副词连用）很，非常 pron. 大量，许多 vt. 分组，把…划分（常与out连用） vi. 抽签，拈阄 
loud	[laʊd] adj. 响亮的，大声的，高声的;响亮的，洪亮的，高亢的 adv. 大声地，高声地，响亮地 
loudspeaker	[ˌlaʊdˈspi:kə(r), ˈlaʊdˌspikɚ] n. 喇叭 
love	[lʌv] vt.&vi. 喜欢 vt. 喜欢 n. 热爱 
lovely	[ˈlʌvli] adj. 可爱的;令人愉快的 n. 美女，美人，佳人;漂亮的东西 
lover	[ˈlʌvɚ, ˈlʌvə(r)] n. 情人 
low	[ləʊ, loʊ] adj. 低的，矮小的 adv. 低声地 n. 低点 vi. （牛）哞哞叫 
lower	[ˈləʊə(r), ˈloʊə(r)] adj. 下方的;在底部的 v. 降低;减少 
loyal	[ˈlɔɪəl] adj. 忠贞的;忠诚的，忠心的 n. 效忠的臣民;忠实信徒 
loyalty	[ˈlɔɪəlti] n. 忠心 
luck	[lʌk] n. 运气;好运 vi. 交好运，走运;侥幸成功 
lucky	[ˈlʌki] adj. 运气好的，侥幸的 
luggage	[ˈlʌɡɪdʒ, ˈlʌgɪdʒ] n. <英>行李 
lump	[lʌmp] n. 肿块 vi. 结成块 vt. 使成团，使成块 adj. 成团的，成块的 adv. 很，非常 
lunch	[lʌntʃ] n. 午餐 vt.&vi. 吃午餐;供给午餐 
luxury	[ˈlʌɡʒəri, ˈlʌkʃə-, ˈlʌkʃəri] n. 奢侈，豪华;奢侈品，美食，美衣 adj. 奢华的，豪华的 
machine	[məˈʃi:n, məˈʃin] n. 机器，机械 vt. 用机器制造，用机器加工 vi. 被机器切削 
machinery	[məˈʃi:nəri, məˈʃinəri, -ˈʃinri] n. （总称）机器 
mad	[mæd] adj. 疯狂的;猛烈的 vt. 使疯狂 
madam	[ˈmædəm] n. 女士 
magazine	[ˈmægəzi:n, ˌmægəˈzi:n] n. 杂志 
magic	[ˈmædʒɪk] n. 魔法 adj. 魔术的 v. 用魔法变出 
magnificent	[mægˈnɪfɪsnt, mæɡˈnɪfɪsənt] adj. 壮丽的 
maid	[meɪd, med] n. 少女 
mail	[meɪl, mel] n. 邮件，邮政 vt. 邮寄 vi. 投邮 
mailbox	[ˈmeɪlbɒks, ˈmeɪlbɑ:ks] n. 信箱 
main	[meɪn, men] adj. 主要的，最重要的;全力的 n. 最主要的部分，重点;主要管道 
mainland	[ˈmenˌlænd, -lənd, ˈmeɪnlænd] n. 大陆;本土 adj. 大陆的;本土的 
mainly	[ˈmenli, ˈmeɪnli] adv. 大部分地 
maintain	[meɪnˈteɪn, menˈten] vt. 保持 
major	[ˈmeɪdʒə(r), ˈmedʒɚ] adj. 主要的 n. 主修科目 vi. <美>主修，专攻 
majority	[məˈdʒɒrəti, məˈdʒɔ:rəti] n. 多数 
make	[meɪk, mek] vt. 做，制造 vi. 开始 n. 制造 
male	[meɪl, ˈmel] adj. 男性的;雄性的 n. 男;雄性动物 
man	[mæn] n. 男人 vt. 使振作 int. （表示惊讶、气愤等）嘿，天哪 
manage	[ˈmænɪdʒ] vt. 经营 vt.&vi. 办理，设法对付 vi. 能解决（问题） 
management	[ˈmænɪdʒmənt] n. 管理 
manager	[ˈmænɪdʒə(r), ˈmænɪdʒɚ] n. 处理者，经理，管理人 
manly	[ˈmænli] adj. 有男子气概的;适合男子的 adv. 以男人的方式 
manner	[ˈmænə(r), ˈmænɚ] n. 方式，方法，做法 
manual	[ˈmænjuəl] adj. 用手的;手制的，手工的 n. 手册;指南 
manufacture	[ˌmænjuˈfæktʃə(r), ˌmænjəˈfæktʃɚ] vt. 加工;制造，生产 n. 制造;制成品，产品 
many	[ˈmɛni, ˈmeni] adj. 许多，多的 pron. （与复数动词连用）大多数人 
map	[mæp] n. 地图，天体图;类似地图的事物 vt. 绘制（一地区等的）地图;勘查 
marble	[ˈmɑ:bl, ˈmɑ:rbl] n. 大理石 adj. 大理石的 v. 把（书边）弄上大理石花纹 
march	[mɑ:tʃ, mɑ:rtʃ] vi. （坚定地向某地）前进 vt. 使前进 n. 行军 
margin	[ˈmɑ:rdʒən, ˈmɑ:dʒɪn] n. 边缘，范围;极限 vt. 留边;成为…的边 
mark	[mɑ:rk, mɑ:k] n. 记号 vt. 作记号 vi. 评分 
market	[ˈmɑ:rkɪt, ˈmɑ:kɪt] n. 交易 vt. 在市场上出售某物 vi. <美>去市场买东西 
marriage	[ˈmærɪdʒ] n. 结婚 
marry	[ˈmæri] vt.&vi. 娶;嫁 vt. 为…主持婚礼 
Marxism	[ˈmɑ:ksɪzəm, ˈmɑ:rksɪzəm] n. 马克思主义 
mask	[mɑ:sk, mæsk] n. 面具 vt. 掩饰 vi. 戴面具 
mass	[mæs] n. 大量，大多 vt.&vi. （使）集中，聚集 adj. 大规模的 vi. 聚集起来 vt. 使集合 
massive	[ˈmæsɪv] adj. 大规模的 
master	[ˈmɑ:stə(r), ˈmæstə(r)] n. 大师 vt. 精通，熟练 adj. 主人的 
match	[mætʃ] n. 比赛 vt. 相同 vt.&vi. 使相配，使相称 
mate	[meɪt, met] n. （工人间的）伙伴，同事，老兄，老弟〔工人，水手间的亲密称呼〕;配偶〔男女任何一方〕，动物之偶（尤指鸟类），（一对中的）一只，配对物 vt.&vi. （使）成为配偶;（使）交配 
material	[məˈtɪəriəl, məˈtɪriəl] n. 素材;材料，原料 adj. 物质的;肉体的 
mathematics	[ˌmæθəˈmætɪks] n. 数学 
matter	[ˈmætɚ, ˈmætə(r)] n. 物质;事件 vi. 要紧，重要;化脓 
may	[me, meɪ] aux. 可以;会 n. [May]五月;山楂属植物 
maybe	[ˈmeɪbi, ˈmebi] adv. 也许;可能 n. 不确定性 
mayor	[ˈmeɪər, meə(r)] n. 市长 
me	[mi] pron. （人称代词I的宾格）我 n. 自我;自我的一部分 
meadow	[ˈmedoʊ, ˈmedəʊ] n. 草地 
meal	[mi:l, mil] n. 餐，饭;进餐（时间） vi. 进餐 
mean	[mi:n, min] v. 意思是 adj. 吝啬的 n. 平均数 
meaning	[ˈmi:nɪŋ, ˈminɪŋ] n. 含义 adj. 有意思的 vt. 意味(mean的现在分词) 
means	[mi:nz] n. 手段;方法（ mean的名词复数） v. 意味着（ mean的第三人称单数）;引起 
meantime	[ˈmi:ntaɪm, ˈminˌtaɪm] n. 其时，其间 adv. 同时，其间 
meanwhile	[ˈmi:nwaɪl, ˈminˌhwaɪl, -ˌwaɪl] adv. 同时，其间 n. 其时，其间 
measure	[ˈmɛʒɚ, ˈmeʒə(r)] n. 措施 vt. 测量 vi. 测量 
meat	[mi:t, mit] n. 肉;食物 adj. 重要的;基本的 
mechanic	[məˈkænɪk, mɪˈkænɪk] n. 技工，机修工 
mechanical	[mɪˈkænɪkəl, məˈkænɪkl] adj. 机械的，机械学的 
mechanics	[mɪ'kænɪks, mɪˈkænɪks] n. 力学 
medal	[ˈmedl, ˈmɛdl] n. 勋章 vi. 获奖：赢得一枚奖章 vt. 授予…奖章 
medical	[ˈmɛdɪkəl, ˈmedɪkl] adj. 医学的;医疗的 n. 体格检查 
medicine	[ˈmɛdɪsɪn, ˈmedsn] n. 医学 
Mediterranean	[ˌmedɪtəˈreɪniən, ˌmɛdɪtəˈreniən, -ˈrenjən] adj. 地中海的 
medium	[ˈmi:diəm, ˈmidiəm] adj. 中等的，中级的;普通的 n. 媒介物，媒质;中间，中庸，[生]培养基，培养液，颜料溶解液，[数]中数，平均，[逻]中名辞 
meet	[mi:t, mit] vt.&vi. 相遇 vt. 满足 n. 运动会，体育比赛 adj. 适当的 
meeting	[ˈmitɪŋ, ˈmi:tɪŋ] n. 会议;聚会 v. 开会;相遇( meet的现在分词) 
melon	[ˈmɛlən, ˈmelən] n. 甜瓜 
melt	[mɛlt, melt] vi. 熔化，溶解;逐渐融合 vt. 熔化，溶解;使混合在一起 
member	[ˈmɛmbɚ, ˈmembə(r)] n. 成员 
membership	[ˈmembərʃɪp, ˈmembəʃɪp] n. 会员资格 
memorial	[məˈmɔ:riəl, məˈmɔriəl, -ˈmor-] n. 纪念碑，纪念物;纪念仪式 adj. 纪念的;悼念的 
memory	[ˈmeməri, ˈmɛməri] n. 记忆，记忆力 
mend	[mend, mɛnd] vt. 修理，修补 vi. 康复，痊愈 n. 修补 
mental	[ˈmentl, ˈmɛntl] adj. 内心的，精神的，思想的，心理的;智慧的，智[脑]力的 n. 精神病患者 
mention	[ˈmɛnʃən, ˈmenʃn] vt. 提到，说起;提名表扬 n. 提及 
menu	[ˈmɛnju, ˈmenju, ˈmenju:] n. 菜单 
merchant	[ˈmɜ:tʃənt, ˈmɜ:rtʃənt] n. 商人;店主 adj. 商人的;商业的 
mercy	[ˈmɜ:si, ˈmɜ:rsi] n. 怜悯 
mere	[mɪr, mɪə(r)] adj. 纯粹的;仅仅，只不过 n. 小湖，池塘;〈英〉边境（线） 
merely	[ˈmɪəli, ˈmɪrli] adv. 只是 
merit	[ˈmɛrɪt, ˈmerɪt] n. 价值，优点 vt. 值得，应获得 vi. 值得，应得 
merry	[ˈmɛri, ˈmeri] adj. 愉快的，快活的;有趣的 n. 甜樱桃;梅里（姓氏） 
mess	[mɛs, mes] n. 混乱 vt. 弄脏 vi. 把事情弄糟 
message	[ˈmesɪdʒ, ˈmɛsɪdʒ] n. 消息;信息 v. 给…发消息;给…留言 
messenger	[ˈmesɪndʒə(r), ˈmɛsəndʒɚ] n. 信使，信差 
metal	[ˈmetl, ˈmɛtl] n. 金属;金属元素 vt. 以金属覆盖 
meter	[ˈmi:tə(r), ˈmitɚ] n. 计量器;计量仪 v. 用仪表测量 
method	[ˈmeθəd, ˈmɛθəd] n. 方法 
midday	[ˌmɪdˈdeɪ, ˈmɪdˌde] n. 中午;正午 adj. 正午的 
middle	[ˈmidl, ˈmɪdl] n. 中央 adj. 中间的 vt. 把…放在中间 vi. 放在中间 
midnight	[ˈmɪdnaɪt, ˈmɪdˌnaɪt] n. 子夜，午夜 
midst	[mɪdst, mɪtst, mɪdst] n. 中部，中间，当中 prep. 在…中间（等于amidst） adv. 在中间，在中央 
might	[maɪt] aux. 表示可能 n. 力气 v. 可以 
mighty	[ˈmaɪti] adj. 强有力的;趾高气扬 adv. 非常，很 
mild	[maɪld] adj. 轻微的;温柔的 n. 淡味麦芽啤酒 
mile	[maɪl] n. 英里 
military	[ˈmɪləteri, ˈmɪlətri] adj. 军事的;军用的 n. 军队;军人 
milk	[mɪlk] n. 奶;母乳 vt. 挤奶;榨取 
mill	[mɪl] n. 磨坊 vt. 研磨，粉碎 vi. 惊跑，乱闯 
millimeter	['mɪlɪˌmi:tə, 'mɪləˌmi:tə] n. 毫米 
million	[ˈmɪljən] n. 百万 adj. 百万的;无数的 
mind	[maɪnd] n. 心，精神，心力，知，智力，智慧 vi. 介意 vt. 专心于 
mine	[maɪn] pron. (I的所有格)我的（东西） n. 矿井 vt.&vi. 在…中开采，开采 vt. 在…中[下]布雷 
miner	[ˈmaɪnɚ, ˈmaɪnə(r)] n. 矿工 
mineral	[ˈmɪnərəl] n. 矿物;矿物质 adj. 矿物的，似矿物的 
minister	[ˈmɪnɪstə(r), ˈmɪnɪstɚ] n. 部长;大臣 vi. 辅助，服侍;执行牧师职务 
ministry	[ˈmɪnɪstri] n. （政府的）部 
minor	[ˈmaɪnɚ, ˈmaɪnə(r)] adj. 较小的，少数的，小… n. 未成年人 vi. [主美国英语]副修，选修，兼修 
minority	[maɪˈnɒrəti, maɪˈnɔ:rəti] n. 少数 
minus	[ˈmaɪnəs] prep. （表示否定）没有 n. 减号 adj. 负的 
minute	[ˈmɪnɪt, 'mɪnɪt] n. 分，分钟;瞬间，片刻 vt. 把…记录在案;为…测定时间 
miracle	[ˈmɪrəkəl, ˈmɪrəkl] n. 奇迹，圣迹，神迹 
mirror	[ˈmɪrə(r), ˈmɪrɚ] n. 镜子，反光镜;真实的写照 vt. 反射;反映 
mischief	[ˈmɪstʃɪf] n. 恶作剧 
misfortune	[ˌmɪsˈfɔ:tʃu:n, ˌmɪsˈfɔ:rtʃu:n] n. 不幸 
miss	[mɪs] n. 女士;（用于姓名或姓之前，对未婚女子的称呼）小姐 v. 思念;漏掉 
missile	[ˈmɪsaɪl, ˈmɪsl] n. 导弹;投射物 adj. 导弹的;可投掷的 
mission	[ˈmɪʃn, ˈmɪʃən] n. 使命;代表团 v. 给…交代任务;派遣 
mist	[mɪst] n. 薄雾 vt. （使）蒙上薄雾 vi. 下雾 
mistake	[mɪˈsteɪk, mɪˈstek] n. 错误，过失，误解 vt.&vi. 弄错，误解 vt. 误会 vi. 弄错 
mistress	[ˈmɪstrəs, ˈmɪstrɪs] n. 情妇 
misunderstand	[ˌmɪsʌndəˈstænd, ˌmɪsʌndərˈstænd] vt. 曲解 
mix	[mɪks] vt.&vi. 混合 n. 混录 vt. 调配，配制 vi. 混合录音，混录，混音 
mixture	[ˈmɪkstʃə(r), ˈmɪkstʃɚ] n. 混合，混杂 
mobilize	[ˈmoʊbəlaɪz, ˈməʊbəlaɪz] vt. 调动;动员 vi. 动员起来 
mock	[mɒk, mɑ:k] vt.&vi. 愚弄，嘲弄 vt. 使受挫折 adj. 模拟的 n. （英国）模拟考试 
model	[ˈmɒdl, ˈmɑ:dl] n. 模型 vt.&vi. 做模特儿 vt. 模仿 adj. 典型的，模范的 
moderate	[ˈmɒdərət, ˈmɑ:dərət] adj. 有节制的 vt. 使和缓 vi. 变缓和 
modern	[ˈmɒdn, ˈmɑ:dərn] adj. 现代的;近代的 n. 现代人，现代主义者;时髦人士 
modify	[ˈmɒdɪfaɪ, ˈmɑ:dɪfaɪ] vi. 修改;被修饰 vt. 改变;减轻，减缓 
moist	[mɔɪst] adj. 潮湿的 
mold	[məʊld, mold] n. 模子 vt. 塑造 vi. 对…产生影响，形成 
moment	[ˈməʊmənt, ˈmoʊmənt] n. 时刻 
Monday	[ˈmʌndeɪ] n. 星期一 
monetary	[ˈmʌnɪtri, ˈmʌnɪteri] adj. 货币的，金钱的 
money	[ˈmʌni] n. 钱 
monitor	[ˈmɑ:nɪtə(r), ˈmɒnɪtə(r)] n. 监测仪 vt. 监督 vi. 监视 
monkey	[ˈmʌŋki] n. 猴 vi. 胡闹 vt. 嘲弄 
monopoly	[məˈnɒpəli, məˈnɑ:pəli] n. 垄断 
month	[mʌnθ] n. 月，月份 
monthly	[ˈmʌnθli] adj. 每月的 n. 月刊 adv. 每月 
monument	[ˈmɒnjumənt, ˈmɑ:njumənt] n. 纪念碑 
mood	[mu:d, mud] n. 心情 
moon	[mu:n, mun] n. 卫星 vi. 闲逛 vt. 虚度 
moral	[ˈmɒrəl, ˈmɔ:rəl] adj. 道德的，道义上的;精神上的 n. 寓意，教训;（尤指男女间的）品行 
more	[mɔ:(r), mɔr, mor] adv. 更，更多 adj. 更多的 pron. 更多的或附加的人或事物 n. 更多 
moreover	[mɔ:rˈoʊvər, mɔ:rˈəʊvə(r)] adv. 而且 
morning	[ˈmɔ:nɪŋ, ˈmɔ:rnɪŋ] n. 早晨 
mortal	[ˈmɔ:rtl, ˈmɔ:tl] adj. 致命的;不共戴天的 n. 凡人，人类 
mortgage	[ˈmɔ:gɪdʒ, ˈmɔ:rgɪdʒ] n. 抵押;抵押单据，抵押证明 vt. 抵押 
most	[məʊst, moʊst] adv. 最，最多（大） adj. many的最高级 n. 大部分 
mostly	[ˈmoʊstli, ˈməʊstli] adv. 大部分，多半 
mother	[ˈmʌðə(r), ˈmʌðɚ] n. 母亲，妈妈;女修道院院长 vt. 像母亲般地照顾;养育 
motion	[ˈməʊʃn, ˈmoʊʃn] n. 运动 vt. 打手势 vi. 运动 
motive	[ˈməʊtɪv, ˈmoʊtɪv] n. 动机，主旨 adj. 动机的 vt. 促使 
motor	[ˈməʊtə(r), ˈmoʊtə(r)] n. 汽车 vi. 开[乘]汽车 vt. 用汽车运送 adj. 有引擎的 
mount	[maʊnt] vt.&vi. 登上 vi. 增加 vt. 安装，架置 n. 山峰 
mountain	[ˈmaʊntən, ˈmaʊntn] n. 山脉 
mountainous	[ˈmaʊntənəs] adj. 多山的 
mouse	[maʊs] n. 鼠标;老鼠 vi. 捕鼠;窥探，偷偷地寻找 
mouth	[maʊθ] n. 口 vt. 装腔作势地说 vi. 装腔作势说话 
move	[mu:v, muv] vt.&vi. 移动，搬动 vi. 行动 vt. 提议 n. 改变 
movement	[ˈmuvmənt, ˈmu:vmənt] n. 运动 
movie	[ˈmu:vi, ˈmuvi] n. 电影 
Mr.	[ˈmɪstɚ, ˈmɪstə] n. 先生 
Mrs.	[ˈmɪsɪz] n. 夫人，太太（对无特殊头衔的已婚妇女的称呼） 
Ms.	[mɪz] n. 女士（对不愿被称为“太太”或“小姐”的女子的称呼） 
much	[mʌtʃ] adv. 非常 adj. 许多的，大量的 pron. 很多 
multiple	[ˈmʌltɪpl, ˈmʌltəpəl] adj. 多重的;多个的 n. <数>倍数;[电工学]并联 
multiply	[ˈmʌltɪplaɪ, ˈmʌltəˌplaɪ] vt.&vi. 乘 adv. 多样地 adj. 多层的 
municipal	[mjuˈnɪsəpəl, mju:ˈnɪsɪpl] adj. 市的，市政的;地方自治的 n. 市政债券 
murder	[ˈmɜ:də(r), ˈmɜ:rdə(r)] n. 谋杀 vt. 凶杀 vi. 杀人 
murderer	[ˈmɜ:dərə(r), ˈmɜ:rdərə(r)] n. 谋杀犯，凶手 
muscle	[ˈmʌsl, ˈmʌsəl] n. 肌肉 vt. 硬挤 vi. 用力挤 
museum	[mjuˈzi:əm, mjuˈziəm] n. 博物馆 
mushroom	[ˈmʌʃrʊm, ˈmʌʃˌrum, -ˌrʊm] n. 蘑菇 adj. 蘑菇的 vi. 迅速增长 
music	[ˈmjuzɪk, ˈmju:zɪk] n. 音乐 
musical	[ˈmju:zɪkl] adj. 悦耳的;音乐的，用于音乐的 n. （社交性的）音乐会;[影视]歌舞片 
musician	[mjuˈzɪʃən, mjuˈzɪʃn] n. 音乐家 
must	[məst, mʌst] aux. 必须 n. 必须做的事，必不可少的事物 vt.&vi. 得 adj. 不可或缺的 
mutual	[ˈmjutʃuəl, ˈmju:tʃuəl] adj. 相互的 
my	[maɪ] adj. 我的(I的所有格形式) int. 啊呀;天啊 
myself	[maɪˈself, maɪˈsɛlf] pron. 我自己，亲自 
mysterious	[mɪˈstɪriəs, mɪˈstɪəriəs] adj. 玄妙 
mystery	[ˈmɪstri, ˈmɪstəri] n. 秘密，谜 
nail	[nel, neɪl] n. 钉子;指甲，趾甲 vt. 钉住;抓住 
naked	[ˈneɪkɪd, ˈnekɪd] adj. 裸体的，裸露的 
name	[neɪm, nem] n. 名字 vt. 确定 adj. 著名的 
namely	[ˈneɪmli, ˈnemli] adv. 即，也就是 
narrow	[ˈnærəʊ, ˈnæroʊ] adj. 狭窄的 vt. 限制，限定 n. 海峡 vi. 变窄 
nation	[ˈneɪʃn, ˈneʃən] n. 国家 
national	[ˈnæʃənəl, ˈnæʃnəl, ˈnæʃnəl] adj. 国家的;国民的 n. [常用复数]全国性比赛;某国国民 
nationality	[ˌnæʃə'næləti, ˌnæʃəˈnæləti] n. 国籍 
native	[ˈneɪtɪv, ˈnetɪv] adj. 本国的;土著的 n. 当地人;土著人 
natural	[ˈnætʃrəl] adj. 自然的;天生的 n. 自然的事情;（生来的）白痴 
nature	[ˈnetʃɚ, ˈneɪtʃə(r)] n. 自然 
naughty	[ˈnɔ:ti, ˈnɔti] adj. 顽皮的 
navigation	[ˌnævɪˈɡeʃən, ˌnævɪˈgeɪʃn] n. 航行（学） 
navy	[ˈneɪvi, ˈnevi] n. 海军 
near	[nɪə(r), nɪr] adv. （空间）在近处 prep. （表示程度）接近 adj. 近的 
nearby	[ˌnɪəˈbaɪ, ˌnɪrˈbaɪ] adj. 在附近的，位于附近的 adv. 附近地，不远地 
nearly	[ˈnɪəli, ˈnɪrli] adv. 几乎，差不多 
neat	[nit, ni:t] adj. 灵巧的 
necessary	[ˈnesəsəri, ˈnesəseri] adj. 必要的;强制的 n. 必需品 
necessity	[nəˈsesəti, nəˈsɛsɪti] n. 必需品 
neck	[nek, nɛk] n. 颈，脖子 vi. 搂着脖子亲吻，相拥互吻 vt. 使变细 
necklace	[ˈnekləs, ˈnɛklɪs] n. 项链 
need	[nid, ni:d] vt. 需要 aux. 必须 n. 需要 vi. （表示应该或不得不做）有必要 
needle	[ˈni:dl, ˈnidl] n. 针 vt. 用针缝，刺 vi. 缝纫 
negative	[ˈnegətɪv, ˈnɛɡətɪv] adj. 消极的，否认的 n. 否定词语 vt. 否定 
neglect	[nɪˈglekt, nɪˈɡlɛkt] vt. 忽略;疏忽 n. 怠慢;玩忽 
negotiate	[nɪˈgəʊʃieɪt, nɪˈgoʊʃieɪt] vi. 谈判，协商，交涉 vt. 谈判达成;成功越过 
negotiation	[nɪˌgəʊʃiˈeɪʃn, nɪˌgoʊʃiˈeɪʃn] n. 协商，谈判 
neighbor	['neɪbə, ˈnebɚ] n. <美>邻居，邻国 adj. 邻近的，邻接的 vi. 友好 vt. 邻接 
neighborhood	['neɪbəhʊd, ˈnebɚˌhʊd] n. 地区 
neither	[ˈnaɪðə(r), ˈniðɚ, ˈnaɪ-] adj. （两者）都不的 pron. 两者都不 adv. 两个都不 conj. 既不 
nephew	[ˈnɛfju, ˈnefju:] n. 侄子，外甥 
nerve	[nɜ:v, nɜ:rv] n. 神经;勇气，胆量 vt. 鼓励，激励;鼓起勇气 
nervous	[ˈnɜ:vəs, ˈnɜ:rvəs] adj. 神经质的 
nest	[nɛst, nest] n. （鸟）窝 vt. 筑巢 vi. 筑巢 
net	[net, nɛt] n. 网 vt. 用网捕 adj. 净的 
network	[ˈnetwɜ:rk, ˈnetwɜ:k] n. 网 vt.&vi. 将…连接成网络 vt. 把（地方节目）编排到广播网（或电视网）联播 vi. 沟通，互助 
neutral	[ˈnu:trəl, ˈnju:trəl] adj. 中立的;（化学中）中性的 n. （汽车或其他机器的）空挡位置;中立人士 
never	[ˈnevə(r), ˈnɛvɚ] adv. 从不，从来没有 
nevertheless	[ˌnevərðəˈles, ˌnevəðəˈles] adv. 不过;然而 conj. 然而;尽管如此 
new	[nju:, nu:] adj. 新的，崭新的;新鲜的，新到的 adv. 新近，最近 
news	[nu:z, nju:z] n. 新闻 
newspaper	[ˈnju:zpeɪpə(r), ˈnu:zpeɪpə(r)] n. 报纸，报 
next	[nekst, nɛkst] adj. 紧接在后的 adv. 接下去 n. 下一个 prep. 靠近 
nice	[naɪs] adj. 美好的，愉快的 
nickname	[ˈnɪkneɪm, ˈnɪkˌnem] n. 昵称;绰号 vt. 给…起绰号;用诨名[爱称]称呼 
niece	[nis, ni:s] n. 侄女 
night	[naɪt] n. 晚上 
nine	[naɪn] num. 九 n. 九，九个 adj. 九的，九个的 
nineteen	[naɪnˈtin, ˌnaɪnˈti:n] num. 十九;十九个 n. 十九岁;十九点钟 
ninety	[ˈnaɪnti] num. 九十 n. 九十 adj. 九十的 
ninth	[naɪnθ] n. 第九;九分之一 adj. 第九的;九分之一的 
no	[noʊ, nəʊ] adv. 不 adj. 没有的 n. 不 abbr. 数字(number) 
noble	[ˈnəʊbl, ˈnoʊbl] adj. 高尚的;贵族的 n. 尊贵的人;旧时在英国使用的金币 
nobody	[ˈnəʊbədi, ˈnoʊbədi] pron. 没有人，无人 n. 小人物，无足轻重的人 
nod	[nɒd, nɑ:d] vi. 点头 vt. 点头示意 n. 点头 
noise	[nɔɪz] n. 噪音 vt. 谣传 vi. 发出声音 
noisy	[ˈnɔɪzi] adj. 嘈杂的;喧闹的 n. 响声;嘈杂声 
nominate	[ˈnɑ:mɪneɪt, ˈnɒmɪneɪt] vt. 任命 
none	[nʌn] pron. 没有一个;没有人，没有一人 adv. 根本不;无法，绝不 
nonsense	[ˈnɑ:nsens, ˈnɒnsns] n. 胡闹 adj. 荒谬的 int. 荒唐 
noon	[nu:n] n. 晌午 
nor	[nɔ:(r), nɔr] conj. 也不 
normal	[ˈnɔ:rml, ˈnɔ:ml] adj. 正常的;正规的，标准的 n. 标准;正常，常态 
north	[nɔ:θ, nɔ:rθ] n. 北方 adj. 北部的 adv. 在北方 
northern	[] adj. 北方的，北部的 
northward	['nɔ:θwəd] adv. 向北方 
nose	[nəʊz, noʊz] n. 鼻子 vt. 嗅出，闻出 vi. 小心探索着前进 
not	[nɒt, nɑ:t] adv. 不 
notable	[ˈnoʊtəbl, ˈnəʊtəbl] adj. 显著的;著名的 n. 名人;显要人物 
note	[noʊt, nəʊt] n. 笔记;音符 vt. 注意;记录 
notebook	[ˈnəʊtbʊk, ˈnoʊtbʊk] n. 笔记本 
nothing	[ˈnʌθɪŋ] pron. 没有东西 n. 无 adv. 毫不 
notice	[ˈnəʊtɪs, ˈnoʊtɪs] n. 注意 vt.&vi. 注意 vt. 通知 vi. 引起注意 
notify	[ˈnəʊtɪfaɪ, ˈnoʊtɪfaɪ] vt. 通知 
notion	[ˈnoʊʃn, ˈnəʊʃn] n. 概念，观念 
noun	[naʊn] n. 名词 
novel	[ˈnɒvl, ˈnɑ:vl] n. （长篇）小说;[法]新法，附律 adj. 新奇的;异常的 
November	[nəʊˈvembə(r), noʊˈvembə(r)] n. 十一月 
now	[naʊ] adv. 现在 adj. 现在的 n. 现在 conj. 由于 
nowadays	[ˈnaʊədeɪz, ˈnaʊəˌdez] adv. 现在，当今 n. 当今，现在 
nowhere	[ˈnoʊwer, ˈnəʊweə(r)] adv. 任何地方都不，无处 n. 无处 adj. 不存在的 
nuclear	[ˈnju:kliə(r), ˈnu:kliə(r)] adj. 原子核的，原子能的 
number	[ˈnʌmbɚ, ˈnʌmbə(r)] n. 数量;号码 v. 标号;总计 
numerous	[ˈnu:mərəs, ˈnju:mərəs] adj. 数不清的 
nurse	[nɜ:rs, nɜ:s] n. 护士，看护 vt.&vi. 护理 vt. 培育 
nursery	[ˈnɜ:rsəri, ˈnɜ:səri] n. 苗圃 
nut	[nʌt] n. 螺母，螺帽;坚果，坚果果仁 v. 采坚果;拾坚果 
nylon	[ˈnaɪlɒn, ˈnaɪlɑ:n] n. [纺]尼龙 
obey	[oˈbe, əˈbeɪ] vt.&vi. 服从，听从 vt. 遵守，遵循 
object	[ˈɑ:bdʒekt, ˈɒbdʒɪkt] n. 物体 
objective	[əbˈdʒektɪv, əbˈdʒɛktɪv] adj. 目标的;客观的，实体的 n. 目标，任务;[光]物镜 
obligation	[ˌɒblɪˈgeɪʃn, ˌɑ:blɪˈgeɪʃn] n. 债务 
oblige	[əˈblaɪdʒ] vt. 强制，强迫;使负债务 vi. 施恩惠;帮忙，效劳 
observation	[ˌɒbzəˈveɪʃn, ˌɑ:bzərˈveɪʃn] n. 观察 
observe	[əbˈzɜ:v, əbˈzɜ:rv] vt.&vi. 观察 vt. 观察 vi. 注意 
obtain	[əbˈtein, əbˈteɪn] vt. 获得，得到;流行 vi. 通行，通用;流行 
obvious	[ˈɒbviəs, ˈɑ:bviəs] adj. 明显的 
occasion	[əˈkeʒən, əˈkeɪʒn] n. 场合;机会，时机 vt. 惹起，引起 
occupation	[ˌɒkjuˈpeɪʃn, ˌɑ:kjuˈpeɪʃn] n. 职业，工作 
occupy	[ˈɒkjupaɪ, ˈɑ:kjupaɪ] vt. 占领 
occur	[əˈkɜ:(r), əˈkɚ] vi. 发生 
ocean	[ˈəʊʃn, ˈoʊʃn] n. 海洋 
October	[ɒkˈtəʊbə(r), ɑ:kˈtoʊbə(r)] n. 十月 
odd	[ɒd, ɑ:d] adj. 古怪的;奇数的 n. 奇特的事物;怪人 
odds	[ɒdz, ɑ:dz] n. 希望，可能性 
odour	[ˈodɚ, ˈəʊdə(r)] n. 气味，臭气 
of	[əv, ʌv] prep. 关于;属于…的 aux. 助动词  [非标准用语、方言] =have [主用于虚拟语气] 
off	[ɒf, ɔ:f] prep. 离开 adv. 离开 adj. 不新鲜的 n. 起跑 v. 杀死 
offense	[əˈfɛns, əˈfens] n. 进攻 
offer	[ˈɒfə(r), ˈɔ:fə(r)] vt. 提供，给予 vi. 提议 n. 提议 
office	[ˈɒfɪs, ˈɔ:fɪs] n. 办公室 
officer	[ˈɒfɪsə(r), ˈɔ:fɪsə(r)] n. 军官，警官;高级职员 v. 指挥;统率 
official	[əˈfɪʃəl, əˈfɪʃl] n. 公务员;行政官员 adj. 正式的;官方的，法定的 
often	[ˈɒfn, ˈɔ:fn] adv. 经常 
oh	[əʊ, o] int. 啊 
oil	[ɔɪl] n. 油 vt. 给…加油 vi. 化成油 
OK	[əʊˈkeɪ, oˈke] adj. 好的 
old	[əʊld, oʊld] adj. 老的;古老的 n. 古时 
omit	[əˈmɪt, oˈmɪt] vt. 省略 
on	[ɒn, ɑ:n] prep. （表示方向）向 adv. （放，穿，连接）上 adj. 活动着的情况，状态 
once	[wʌns] adv. 一旦 conj. 一旦…就… n. 一次，一回 
one	[wʌn] num. 一个 n. 一个人 pron. 一个人 adj. 某一个的 
oneself	[wʌnˈself, wʌnˈsɛlf] pron. 自己，自身 
onion	[ˈʌnjən] n. 洋葱（头） 
only	[ˈəʊnli, ˈoʊnli] adj. 唯一的 adv. 只，仅仅 conj. 但是，可是 
onto	[ˈɒntə, ˈɑnˌtu, -tə, ˈɔn-] prep. 到…之上;对…了解 adj. 映射的;自身的 
open	[ˈəʊpən, ˈoʊpən] adj. 敞开的，开着的 vt.&vi. （打）开 n. 公开 vi. 使打开 vt. 开放 
opening	[ˈəʊpnɪŋ, ˈoʊpnɪŋ] n. 开幕，开始 adj. 首次的，开始的 v. （打）开( open的现在分词) 
opera	[ˈɒprə, ˈɑ:prə] n. 歌剧 
operate	[ˈɒpəreɪt, ˈɑ:pəreɪt] vt.&vi. 操作 vi. 开刀 vt. 操作，控制，使运行 
operation	[ˌɑ:pəˈreɪʃn, ˌɒpəˈreɪʃn] n. 手术 
operator	[ˈɒpəreɪtə(r), ˈɑ:pəreɪtə(r)] n. 操作员 
opinion	[əˈpɪnjən] n. 意见，主张 
opponent	[əˈpəʊnənt, əˈpoʊnənt] n. 对手;敌手 adj. 对立的;敌对的 
opportunity	[ˌɒpəˈtju:nəti, ˌɑ:pərˈtu:nəti] n. 机会 
oppose	[əˈpoʊz, əˈpəʊz] vt.&vi. 抵制 
opposite	[ˈɒpəzɪt, ˈɑ:pəzət] adj. 对面的 prep. （表示位置）在…的对面 adv. 在对面，对过 n. 对立面，对立物，相反的人[事物] 
or	[ɔ:(r), ɔr] conj. 还是 prep. <古、诗>在…之前，比…更早 n. [纹章]黑金色、黑色 
oral	[ˈɔ:rəl, ˈɔrəl] adj. 口服的;口头的，口述的 n. （尤指外语考试中的）口试 
orange	[ˈɒrɪndʒ, ˈɔ:rɪndʒ] n. 橙色;桔子，橙子 adj. 橙色的;橘色的 
order	[ˈɔ:rdə(r), ˈɔ:də(r)] n. 秩序 vt. 命令 vi. 下订单 
orderly	[ˈɔ:dəli, ˈɔ:rdərli] adj. 整齐的，有秩序的 n. [军]传令下士 adv. 依次地，顺序地 
ordinary	[ˈɔ:rdneri, ˈɔ:dnri] adj. 普通的 
organ	[ˈɔ:rgən, ˈɔ:gən] n. 器官 
organization	[ˌɔ:rgənəˈzeɪʃn, ˌɔ:gənaɪˈzeɪʃn] n. 组织;机构 adj. 有组织的 
organize	[ˈɔ:gənaɪz, ˈɔ:rgənaɪz] v. 组织 
orient	[ˈɔriənt, -ˌɛnt, ˈor-, ˈɔ:rient] vt. 标定方向 adj. 东方的 vi. 转向东方 n. 东亚各国 
origin	[ˈɒrɪdʒɪn, ˈɔ:rɪdʒɪn] n. 出身 
original	[əˈrɪdʒənl, əˈrɪdʒənəl] adj. 原始的;最初的 n. 原件;原文 
ornament	[ˈɔ:nəmənt, ˈɔ:rnəmənt] n. 装饰;装饰物 v. 装饰;美化 
other	[ˈʌðər, ˈʌðə(r)] adj. 其他的 pron. 其他的 n. [the other]对立面；对立的事物 
otherwise	[ˈʌðəwaɪz, ˈʌðərwaɪz] adv. 否则 adj. 别的，另外的 conj. 否则，不然 
ought	[ɔt, ɔ:t] aux. 应该（指道义上有责任）;应当（显示所采取行动正确或明智） vt.&vi. 应该（指道义上有责任）;（表示愿望）应当（显示所采取行动正确或明智） 
ounce	[aʊns] n. 盎司 
our	[aʊr, ɑ:(r)] pron. 我们的，we的所有格形式 
ours	[ˈaʊəz, ˈaʊərz] pron. 我们的 
ourselves	[ɑ:rˈselvz, ɑ:ˈselvz] pron. 我们自己 
out	[aʊt] adv. 出局 prep. （表示来源）从 vt. 使熄灭 adj. 外面的 n. 不流行 
outbreak	[ˈaʊtˌbrek, ˈaʊtbreɪk] n. （战争，怒气等的）爆发;突然发生 vi. 爆发 
outcome	[ˈaʊtkʌm, ˈaʊtˌkʌm] n. 结果 
outdoor	[ˈaʊtdɔ:(r), ˈaʊtˌdɔr, -ˌdor] adj. 室外 
outdoors	[ˌaʊtˈdɔ:z, ˌaʊtˈdɔ:rz] adv. 在户外;向户外 n. 户外;野外 
outer	[ˈaʊtɚ, ˈaʊtə(r)] adj. 外面的，外部的;远离内部（中心）的 n. 环外命中 
outline	[ˈaʊtlaɪn, ˈaʊtˌlaɪn] n. 梗概，大纲，提纲，草稿，要点，主要原则;外形，轮廓，轮廓线，轮廓画法，略图（画法） vt. 概述;略述 
output	[ˈaʊtˌpʊt, ˈaʊtpʊt] n. 输出;产量 vt. 输出 
outside	[ˌaʊtˈsaɪd, aʊtˈsaɪd, ˈaʊtˌsaɪd] adv. 在外面 n. 外面 adj. 外部的 prep. （表示位置）在[向]…的外面 
outstanding	[aʊtˈstændɪŋ, aʊtˈstændɪŋ, ˈaʊtˌstæn-] adj. 杰出的 
over	[ˈoʊvə(r), ˈəʊvə(r)] prep. （表示方向）越过 adv. 结束 adj. 过去的 n. 额外 int. [电信学]报文完，请回复！ vt. 走过，跳过 
overcoat	[ˈəʊvəkəʊt, ˈoʊvərkoʊt] n. 大衣 
overcome	[ˌoʊvərˈkʌm, ˌəʊvəˈkʌm] vt.&vi. 战胜，克服 vt. 被（烟、感情等）熏[压]倒，使受不了 vi. 受到…的极大影响 
overhead	[ˌəʊvəˈhed, ˌoʊvərˈhed] adj. 头顶上的 n. 天花板 adv. 在头顶上 
overhear	[ˌəʊvəˈhɪə(r), ˌoʊvərˈhɪr] vt. 偷听;无意中听到 vi. 偷听到;无意中听到 
overlook	[ˌəʊvəˈlʊk, ˌoʊvərˈlʊk] vt. 远眺;忽视，忽略 n. 从高处眺望到的景色;忽视，忽略 
overnight	[ˌəʊvəˈnaɪt, ˌoʊvərˈnaɪt] adv. 在晚上 adj. 一整夜的 n. 前一天的晚上 vi. 过一夜 
overseas	[ˌəʊvəˈsi:z, ˌoʊvərˈsi:z] adv. 在[向]海外，在[向]国外 adj. （在）海外的，（在）国外的;（向或来自）外国的 
overtake	[ˌəʊvəˈteɪk, ˌoʊvərˈteɪk] vt. 压倒 
overtime	[ˈəʊvətaɪm, ˈoʊvərtaɪm] n. 加班 adv. 超时地 v. 使历时过久 
owe	[əʊ, oʊ] vt. 感激 
owing	[ˈoʊɪŋ, ˈəʊɪŋ] adj. 欠着的，应付的，未付的 v. 感激( owe的现在分词 );应把…归功于 
owl	[aʊl] n. 猫头鹰 
own	[əʊn, oʊn] n. 自己的事物 vt. 拥有 vi. 承认 adj. 自己的 
owner	[ˈəʊnə(r), ˈoʊnə(r)] n. 物主，所有人 
ownership	[ˈoʊnərʃɪp, ˈəʊnəʃɪp] n. 所有权 
ox	[ɒks, ɑ:ks] n. 牛，公牛 
oxygen	[ˈɒksɪdʒən, ˈɑ:ksɪdʒən] n. [化]氧，氧气 
pace	[peɪs] n. 一步 vt. 踱步，走来走去 vi. 踱 prep. 蒙…恩准，怀着对…的敬意 
pacific	[pəˈsɪfɪk] adj. 太平洋的 
pack	[pæk] n. 包裹 vt.&vi. （把…）打包 vt. 挑选 vi. 包装 
package	[ˈpækɪdʒ] vt. 包装;把…装箱 n. 包裹;包装袋 
packet	[ˈpækɪt] n. 小包;信息包 vt. 包装，打包;用邮船运送 
pad	[pæd] vt. 给…装衬垫， 加垫子 vi. 步行，放轻脚步走 n. 垫，衬垫 
page	[peɪdʒ, pedʒ] n. 页 vt. 标记…的页数 vi. 翻书页 
pail	[pel, peɪl] n. 桶，提桶 
pain	[pen, peɪn] n. 痛苦 vt.&vi. （使）疼痛，（使）痛苦，伤害 vt. 使…痛苦 vi. 感到疼痛 
painful	[ˈpeɪnfl, ˈpenfəl] adj. 痛苦的 
paint	[peɪnt, pent] n. 颜料，涂料 vt. 绘画 vi. 描绘 
painter	[ˈpeɪntə(r), ˈpentɚ] n. 画家，着色者 
painting	[ˈpeɪntɪŋ, ˈpentɪŋ] n. 绘画;油画 v. 绘画（ paint的现在分词）;涂色于 
pair	[peə(r), per] n. 一副 vt.&vi. （使…）成对，（使…）成双 vi. 交配，交尾 
palace	[ˈpælɪs, ˈpæləs] n. 宫，宫殿 
pale	[pel, peɪl] adj. 苍白的 vi. 变得苍白 vt. 用栅栏围 n. 栅栏，围篱 
palm	[pɑ:m] n. 手掌;手心 v. 将…藏于掌中 
pamphlet	[ˈpæmflət, ˈpæmflɪt] n. 小册子 
pan	[pæn] n. 平底锅 vt. 淘金 vi. 淘金 
panda	[ˈpændə] n. 熊猫 
paper	[ˈpeɪpə(r), ˈpeɪpər] n. 纸 vt.&vi. 贴纸 vt. 包装，用纸覆盖 vi. 贴糊墙纸 adj. 纸制的 
parade	[pəˈreɪd, pəˈred] v. 游行;展览 n. 游行;检阅 
paradise	[ˈpærədaɪs, ˈpærəˌdaɪs, -ˌdaɪz] n. 天堂 
paragraph	[ˈpærəgrɑ:f, ˈpærəgræf] n. 段落;分段符号 vt. 将…分段;写短文报导 
parallel	[ˈpærəlel, ˈpærəˌlɛl] adj. 平行的 adv. 平行地，并列地 n. 平行线（面） vt. 使平行 
parcel	[ˈpɑ:sl, ˈpɑ:rsl] n. 包袱，包裹;（土地的）一块 vt. 分，区分;把…划成部分后分配 
pardon	[ˈpɑ:dn, ˈpɑ:rdn] vt. 原谅 n. 赦免 int. （用于请求别人重复某事）什么，请再说一遍 
parent	[ˈperənt, ˈpeərənt] n. 父亲（或母亲） 
Paris	[ˈpærɪs, 'pærɪs] n. 巴黎 
park	[pɑ:k, pɑ:rk] n. 公园 vi. 泊车，停车 vt. 停车 
parliament	[ˈpɑ:ləmənt, ˈpɑ:rləmənt] n. 议会，国会 
part	[pɑ:t, pɑ:rt] n. 部分 vt. 使分裂 vi. 分开 adv. 不完全地，部分地 adj. 不完全的，部分的 
participate	[pɑ:rˈtɪsɪpeɪt, pɑ:ˈtɪsɪpeɪt] vi. 参加某事;分享某事 vt. 得到或接受某部分东西 
particular	[pərˈtɪkjələ(r), pəˈtɪkjələ(r)] adj. 特别的;详细的 n. 特色，特点;（可分类，列举的）项目 
partly	[ˈpɑ:tli, ˈpɑ:rtli] adv. 半 
partner	[ˈpɑ:rtnə(r), ˈpɑ:tnə(r)] n. 伙伴 vt. 使合作 vi. 合伙 
party	[ˈpɑ:ti, ˈpɑ:rti] n. 当事人 v. 为…举行社交聚会 adj. 政党的，党派的 
pass	[pæs, pɑ:s] vt.&vi. 通过 vt. 传球 n. 通行证 
passage	[ˈpæsɪdʒ] n. （文章的）一段 
passenger	[ˈpæsəndʒɚ, ˈpæsɪndʒə(r)] n. 乘客，旅客 
passerby	['pɑ:sə'baɪ, ˈpæsɚˌbaɪ, -ˈbaɪ] n. 过路人，行人 
passion	[ˈpæʃn] n. 激情，热情;热心，爱好 vt.&vi. [诗歌用语]表露强烈感情，显示巨大热情 
passive	[ˈpæsɪv] adj. 被动的;消极的 n. 动词被动形式，被动语态 
passport	[ˈpɑ:spɔ:t, ˈpæspɔ:rt] n. 护照，通行证 
past	[pæst, pɑ:st] adj. 过去的，以前的 n. 往事 prep. 超过，超出 adv. 经过，超过 
paste	[pest, peɪst] n. 面团;糨糊 vt. 粘贴，张贴;以…覆盖于 
pastime	[ˈpɑ:staɪm, ˈpæstaɪm] n. 消遣，娱乐 
pasture	[ˈpæstʃə(r), ˈpɑ:stʃə(r)] n. 牧草地，牧场 vt.&vi. 放牧 vi. 吃草 
pat	[pæt] vt.&vi. 轻拍，爱抚 n. 轻拍 adj. 恰好的，适当的 vt. 表扬，称赞（某人/自己） 
patent	[ˈpætnt] n. 专利 adj. 专利的 vt. 获得…专利，给予…专利权 
path	[pɑ:θ, pæθ] n. 小路，路 
patience	[ˈpeʃəns, ˈpeɪʃns] n. 忍耐 
patient	[ˈpeɪʃnt, ˈpeʃənt] adj. 有耐性的;能容忍的 n. 病人;患者 
pattern	[ˈpætərn, ˈpætn] n. 模式 vt. 模仿 vi. 形成图案 
pause	[pɔ:z, pɔz] n. 暂时的停顿;犹豫 vi. 暂停，中止;逗留，停滞 
pavement	[ˈpeɪvmənt, ˈpevmənt] n. 人行道 
pay	[peɪ, pe] vt.&vi. 付款 vt. 支付 n. 工资 adj. 收费的 
payment	[ˈpeɪmənt, ˈpemənt] n. 付款，支付 
pea	[pi:] n. 豌豆，豌豆类 
peace	[pi:s, pis] n. 和平 
peaceful	[ˈpisfəl, ˈpi:sfl] adj. 和平的 
peach	[pitʃ, pi:tʃ] n. 桃子;桃红色 adj. 桃红色的;粉红色的 
peak	[pi:k, pik] n. 山峰 vi. 达到高峰，达到最大值 adj. 最高的 
peanut	[ˈpiˌnʌt, ˈpi:nʌt] n. 花生;微不足道的人，小人物 adj. 微不足道的 
pear	[peə(r), per] n. 梨树 
pearl	[pɜ:l, pɜ:rl] n. 珍珠 vi. 采珍珠 vt. 使成珠状 
peasant	[ˈpɛzənt, ˈpeznt] n. 农民 
peculiar	[pɪˈkju:liə(r), pɪˈkjuljɚ] adj. 奇怪的，古怪的;异常的 n. 专有特权，专有财产;[多用于英国]特殊教堂 
peel	[pil, pi:l] vt. 剥皮 vi. 剥落 n. 果皮，蔬菜皮 
pen	[pen, pɛn] n. 笔，笔尖;笔法，文笔 vt. 写;把…关入栏中 
penalty	[ˈpenəlti, ˈpɛnəlti] n. 刑罚 
pencil	[ˈpensl, ˈpɛnsəl] n. 铅笔，彩色铅笔;笔状物 vt. 用铅笔写;用画笔画 
penny	[ˈpeni, ˈpɛni] n. 便士 
pension	[ˈpenʃn, ˈpɛnʃən] n. 退休金，养老金;膳宿费 vt. 发给…养老金[退休金];准予退休，强迫退休（并发给退休金） 
people	[ˈpi:pl, ˈpipəl] n. 人民;人，人类 vt. 居住于，布满;使住满人，在…殖民 
pepper	[ˈpɛpɚ, ˈpepə(r)] n. 辣椒;胡椒 vt. 在…上撒胡椒粉;使布满 
per	[pə(r), pɚ] prep. 由 adv. 每个 adj. 高的，过的，全的 
perceive	[pəˈsi:v, pərˈsi:v] v. 理解 
percent	[pɚˈsɛnt, pə'sent] n. 百分比，百分数 adj. 百分之…的，每一百中有…的 adv. 以百分之…地，每一百中有…地 
percentage	[pərˈsentɪdʒ, pəˈsentɪdʒ] n. 百分比，百分率 
perfect	[ˈpɜ:fɪkt, ˈpɜ:rfɪkt] adj. 完美的;正确的 n. [语]完成时 
perform	[pərˈfɔ:rm, pəˈfɔ:m] vt.&vi. 执行 vt. 进行 vi. 运行，表现 
performance	[pəˈfɔ:məns, pərˈfɔ:rməns] n. 表现 
perfume	[ˈpɜ:fju:m, pərˈfju:m] n. 香水;香料 vt. 使…充满香气;喷香水于… 
perhaps	[pərˈhæps, pəˈhæps] adv. 或许;（表示不确定）也许 n. 假定;猜想 
period	[ˈpɪəriəd, ˈpɪriəd] n. 时期;（一段）时间 adj. 具有某个时代特征的;（关于）过去某一特定历史时期的 
perish	[ˈpɛrɪʃ, ˈperɪʃ] vi. 毁灭;死亡，丧生 vt. 使麻木;使毁坏 
permanent	[ˈpɜ:mənənt, ˈpɜ:rmənənt] adj. 永久（性）的，永恒的，不变的，耐久的，持久的，经久的;稳定的 n. 电烫发，烫发 
permission	[pəˈmɪʃn, pərˈmɪʃn] n. 允许 
permit	[pəˈmɪt, pərˈmɪt] vt. 许可，准许 vi. 许可，允许 n. 许可，准许 
persist	[pərˈsɪst, pəˈsɪst] v. 坚持 
person	[ˈpɜ:rsn, ˈpɜ:sn] n. 人 
personal	[ˈpɜ:rsənl, ˈpɜ:sənl] adj. 个人的，私人的;身体的 n. （报刊上的）人事栏，分类人事广告版;人称代名词 
personality	[ˌpɜ:rsəˈnæləti, ˌpɜ:səˈnæləti] n. 生而为人 
persuade	[pərˈsweɪd, pəˈsweɪd] vt.&vi. 说服 
persuasion	[pəˈsweɪʒn, pərˈsweɪʒn] n. 劝说，说服（力） 
pest	[pest, pɛst] n. 讨厌的人或事 
pet	[pɛt, pet] n. 宠物 adj. 宠爱的，溺爱的 vt. 宠爱 vi. <非正>亲吻 
petroleum	[pəˈtrəʊliəm, pəˈtroʊliəm] n. 石油 
phase	[fez, feɪz] n. 阶段 vt. 分阶段实行 vi. 分阶段进行 
philosopher	[fəˈlɒsəfə(r), fəˈlɑ:səfə(r)] n. 哲学家，哲人 
philosophy	[fəˈlɑ:səfi, fəˈlɒsəfi] n. 哲学 
phone	[fəʊn, foʊn] n. 电话;听筒 vt.&vi. 打电话（给某人） 
photo	[ˈfoʊtoʊ, ˈfəʊtəʊ] n. 照片，相片 vt.&vi. （给…）拍照 
phrase	[frez, freɪz] n. 成语 vt. 叙述，措词 vt.&vi. 划分乐句，分乐节（尤指为奏乐或歌唱） 
physical	[ˈfɪzɪkl, ˈfɪzɪkəl] adj. 身体的;自然（界）的 n. 身体检查，体格检查 
physician	[fɪˈzɪʃn, fɪˈzɪʃən] n. 医生，内科医生 
physicist	[ˈfɪzɪsɪst] n. 物理学家 
physics	[ˈfɪzɪks] n. 物理学 
piano	[piˈænoʊ, piˈænəʊ] n. 钢琴 
pick	[pɪk] vt.&vi. 挑选，挑拣;挖，采，摘，剔，扒 n. 选择;收获 
pickpocket	[ˈpɪkpɒkɪt, ˈpɪkpɑ:kɪt] n. 扒手 
pickup	[ˈpɪkˌʌp, ˈpɪkʌp] n. 收集;<口>搭车（者） adj. 临时凑成的，偶然认识的 
picnic	[ˈpɪknɪk] n. 野餐郊游 vi. 去野餐，参加野餐 vt. 用野餐招待 
picture	[ˈpɪktʃɚ, ˈpɪktʃə(r)] n. 照片，画像;图画，图片 vt. 构想，想象;描绘，画 
pie	[paɪ] n. 馅饼，派;爱说话的人 vt. 使杂乱;弄乱（铅字，版面） 
piece	[pi:s, pis] n. 块，片，段;部分，部件 vt. 修补;连接，接上 
pig	[pɪg, pɪɡ] n. 猪 vi. 生小猪 vt. 吃得过量，大吃特吃 
pillow	[ˈpɪləʊ, ˈpɪloʊ] n. 枕头 vt. 搁于枕上 vi. 以…为枕 
pilot	[ˈpaɪlət] n. 飞行员 vt. 试点 adj. 试验性的 
pin	[pɪn] n. 钉 vt. 压住 adj. 销的 
pine	[paɪn] n. 松树 vi. 憔悴 vt. 为…悲哀 adj. 似松的 
pink	[pɪŋk] adj. 粉红色的 n. 粉红色 vt. 刺、扎 
pioneer	[ˌpaɪəˈnɪə(r), ˌpaɪəˈnɪr] n. 先驱者;拓荒者 vt. 开拓，开发;做（…的）先锋 
pipe	[paɪp] n. 管子 vt. 以管输送 vi. 吹奏管乐器 
pistol	[ˈpɪstəl, ˈpɪstl] n. 手枪 v. 用手枪射击 
pit	[pɪt] n. 井 vt. 使有麻子 vi. 凹陷 
pitch	[pɪtʃ] n. 音高 vt. 用沥青涂 vi. 抛，扔 
pity	[ˈpɪti] n. 怜悯;同情 vt. 对…表示怜悯;对…感到同情 
place	[ples, pleɪs] n. 地方 vt. 放置 vi. 得名次 
plain	[pleɪn, plen] n. 平原 adj. 平的 adv. 清楚地，明白地 vi. 发牢骚 
plan	[plæn] n. 计划;打算 vt.&vi. 计划，打算，设计 
plane	[pleɪn, plen] n. 平面 adj. 平的，平坦的 vt. 用刨刨平 vi. 鸟滑翔 
planet	[ˈplænɪt] n. [天]行星 
plant	[plɑ:nt, plænt] n. 工厂;设备 vt. 种植;安，插 
plastic	[ˈplæstɪk] n. 整形;塑料制品 adj. 可塑的，塑性的，受范的，柔软的;造型的，塑造的，给与形态的 
plate	[pleɪt, plet] n. 盘子，盆子;金属板 vt. 镀，在…上覆盖金属板;覆盖 
platform	[ˈplætfɔ:m, ˈplætfɔ:rm] n. 平台;台 v. 把…放在台上;为…设（平）台 
play	[pleɪ] n. 游戏 vt.&vi. 玩 vt. 扮演 vi. 玩耍，游戏 
player	[ˈpleɚ, ˈpleɪə(r)] n. 播放机 
playground	[ˈpleɪgraʊnd, ˈpleˌɡraʊnd] n. 游乐场 
plead	[pli:d, plid] vi. 恳求 vt. 以…为理由 vt.&vi. 申诉，答辩，为…辩护 
pleasant	[ˈpleznt, ˈplɛzənt] adj. 令人愉快的 
please	[pli:z, pliz] int. 请 vt.&vi. 讨好;使高兴 
pleased	[, pli:zd] adj. 高兴的;自鸣得意 v. 喜欢;（使…）高兴( please的过去式) 
pleasure	[ˈplɛʒɚ, ˈpleʒə(r)] n. 愉快 vt. 使高兴 vi. 觉得高兴，享受 
plentiful	[ˈplɛntɪfəl, ˈplentɪfl] adj. 丰富的 
plenty	[ˈplɛnti, ˈplenti] n. 充裕 adv. 大量 det. 大量 pron. 大量 
plot	[plɒt, plɑ:t] n. 地基，基址图 vt. 密谋 vi. 设计作品情节 
plow	[plaʊ] n. 犁;犁型铲雪机 v. 耕;犁耕 
plug	[plʌɡ, plʌg] n. 插头 vt.&vi. 插上插头 vt. 插入 vi. 填塞，堵 
plunge	[plʌndʒ] vt. 用力插入 vi. 跳入 n. 投入，陷入 
plural	[ˈplʊrəl, ˈplʊərəl] adj. 复数的 n. 复数;复数形式 
plus	[plʌs] prep. （表示运算）加 n. 加号 adj. 加的 
PM	[ˌpi:'em, ˌpi: ˈem] abbr. 下午(Post Meridiem
pocket	[ˈpɑ:kɪt, ˈpɒkɪt] n. 口袋，钱袋 vt. 隐藏 adj. 放在口袋里的 
poem	[ˈpoʊəm, ˈpəʊɪm] n. 诗 
poet	[ˈpəʊɪt, ˈpoʊət] n. 诗人 
poetry	[ˈpəʊətri, ˈpoʊətri] n. 诗，诗歌 
point	[pɔɪnt] n. 点 vt. （意思上）指向 vi. 指向 
poison	[ˈpɔɪzən, ˈpɔɪzn] n. 毒药 vt. 毒死 adj. 有毒的 
poisonous	[ˈpɔɪzənəs] adj. 有毒的 
pole	[poʊl, pəʊl] n. 杆 vt.&vi. 用篙撑船，摆船 vt. [航海] 用一根杆来推动 vi. 用滑雪杖加速 
police	[pəˈlis, pəˈli:s] n. 警察 vt. （警察、军队等）巡查 adj. 警察的 
policeman	[pəˈli:smən, pəˈlismən] n. （男）警察，警员 
policy	[ˈpɒləsi, ˈpɑ:ləsi] n. 政策 
polish	[ˈpɑ:lɪʃ, ˈpɒlɪʃ] v. 磨光;润色 n. 光泽剂，擦亮剂;擦亮，磨光 
polite	[pəˈlaɪt] adj. 有礼貌的 
political	[pəˈlɪtɪkl, pəˈlɪtɪkəl] adj. 政治的 
politician	[ˌpɑ:ləˈtɪʃn, ˌpɒləˈtɪʃn] n. 政治家 
politics	[ˈpɒlətɪks, ˈpɑ:lətɪks] n. 政治 
poll	[poʊl, pəʊl] n. 民意调查 vt. 得到（一定数目的）选票 vi. 投票 
pollute	[pəˈlu:t, pəˈlut] vt. 污染 
pollution	[pəˈluʃən, pəˈlu:ʃn] n. 污染（作用） 
pond	[pɒnd, pɑ:nd] n. 池塘 v. 筑成池塘 
pool	[pul, pu:l] n. 水池;石油层 vi. 使形成池塘或水洼;淤积 
poor	[pɔ:(r), pɔ:r] adj. 贫穷的，贫乏的;令人怜悯的，可怜的 n. the poor 贫困者，穷人 
pop	[pɑ:p, pɒp] vi. （意外地、突然地）出现 vt. （突然地）伸出 n. 流行音乐 adj. 流行音乐的 adv. 爆炸；砰地 abbr. 邮局协议(post office protocol) 
popular	[ˈpɒpjələ(r), ˈpɑ:pjələ(r)] adj. 流行的，大众化的 
population	[ˌpɑ:pjuˈleɪʃn, ˌpɒpjuˈleɪʃn] n. 人口 
porch	[pɔ:rtʃ, pɔ:tʃ] n. 门廊 
pork	[pɔ:rk, pɔ:k] n. 猪肉 
port	[pɔ:t, pɔ:rt] n. 港口 vt. 举枪 vi. 转向左舷 adj. 左舷的，左侧的 vt.&vi. 转舵（向左），把（舵）转向左边 adv. 向左舷，向左 
porter	[ˈpɔ:rtə(r), ˈpɔ:tə(r)] n. 门童 
portion	[ˈpɔ:ʃn, ˈpɔ:rʃn] n. 一部分;一份遗产（或赠与的财产） vt. 把…分成份额;分配 
portrait	[ˈpɔ:treɪt, ˈpɔ:rtrət] n. 肖像，肖像画 
position	[pəˈzɪʃən, pəˈzɪʃn] n. 位置，方位;地位，职位 vt. 安置;把…放在适当位置 
positive	[ˈpɒzətɪv, ˈpɑ:zətɪv] adj. 积极的;确实的，肯定的 n. 正面;正片 
possess	[pəˈzes, pəˈzɛs] vt. 拥有 
possession	[pəˈzeʃn, pəˈzɛʃən] n. 有，所有，拥有 
possibility	[ˌpɒsəˈbɪləti, ˌpɑ:səˈbɪləti] n. 可能，可能性 
possible	[ˈpɒsəbl, ˈpɑ:səbl] adj. 可能的;可接受的 n. 可能性，潜在性;可能的人物，可能有的事 
possibly	[ˈpɒsəbli, ˈpɑ:səbli] adv. 可能地 
post	[poʊst, pəʊst] n. 岗位 vt. 张贴 vi. 快速行进 adj. 有关赛跑（或赛马，赛狗）起点标志的 adv. 〈外〉在后 
postage	[ˈpoʊstɪdʒ, ˈpəʊstɪdʒ] n. 邮费，邮资 
postcard	[ˈpoʊstkɑ:rd, ˈpəʊstkɑ:d] n. 明信片 
poster	[ˈpəʊstə(r), ˈpoʊstə(r)] n. 招贴画 
postman	[ˈpəʊstmən, ˈpoʊstmən] n. 邮递员，邮差 
postpone	[poʊˈspoʊn, pəˈspəʊn] vt. 使延期，延缓;把…放在次要地位 vi. 延缓;延缓发作 
pot	[pɑ:t, pɒt] n. 罐 vt. 把…栽入盆中 vi. 随手射击 
potato	[pəˈteɪtoʊ, pəˈteɪtəʊ] n. 马铃薯， 土豆，洋芋 
pound	[paʊnd] n. 磅 vt.&vi. 连续重击 vi. （持续地）苦干 vt. 连续重击 
pour	[pɔ:(r), pɔr, por] vt. 涌出 vi. 涌流 n. 倾泻 
poverty	[ˈpɑ:vərti, ˈpɒvəti] n. 贫穷 
powder	[ˈpaʊdə(r), ˈpaʊdɚ] n. 粉，粉末 vt. 在…搽粉 vi. 涂粉，变成粉末 
power	[ˈpaʊə(r), ˈpaʊɚ] n. 力量 vt. 运转 vi. 靠动力行进 adj. 权力的 
powerful	[ˈpaʊəfl, ˈpaʊərfl] adj. 强大的;权力大的 adv. 很;非常 
practical	[ˈpræktɪkl, ˈpræktɪkəl] adj. 实践的，实际的 
practice	[ˈpræktɪs] n. 实践 vi. 练习 vt. 练习 
praise	[preɪz] n. 赞扬，称赞;崇拜 v. 歌颂;赞扬，赞美 
pray	[pre, preɪ] vt. 祈祷，祷告;请求，恳求 vi. 祈祷;请 
prayer	[preə(r), prer] n. 祈祷 
preach	[pritʃ, pri:tʃ] vt.&vi. 宣扬;说教 n. 〈口〉讲道，说教 
precious	[ˈprɛʃəs, ˈpreʃəs] adj. 贵重的 adv. <口>很，非常 n. 珍爱的人 
precise	[prɪˈsaɪs] adj. 精密 
prefer	[prɪˈfɚ, prɪˈfɜ:(r)] vt. 更喜欢;提升，提拔 vi. 更喜欢，宁愿 
prejudice	[ˈprɛdʒədɪs, ˈpredʒudɪs] n. 侵害;成见，偏见，歧视 vt. 使有偏见;不利于，损害 
premier	[ˈpremiə(r), prɪˈmɪr] n. 总理;首相 adj. 首要的;第一的，首位的 
preparation	[ˌprɛpəˈreʃən, ˌprepəˈreɪʃn] n. 制剂 
prepare	[prɪˈper, prɪˈpeə(r)] vt. 准备;预备（饭菜） vt.&vi. 筹备，进行各项准备工作;做好思想准备 
presence	[ˈprezns, ˈprɛzəns] n. 出席 
present	[ˈpreznt, ˈprɛznt] adj. 目前的;现在的 n. 现在;礼物 
presently	[ˈprezntli, ˈprɛzəntli] adv. 目前 
preserve	[prɪˈzɜ:v, prɪˈzɜ:rv] vt. 保护 vi. 保鲜 n. 蜜饯 
president	[ˈprɛzɪdənt,-ˌdɛnt, ˈprezɪdənt] n. 总统 
press	[pres, prɛs] vt. 压，按 vi. 压 n. 压榨 
pressure	[ˈpreʃə(r), ˈprɛʃɚ] n. 压力;压（力） vi. 施加压力;迫使 
pretend	[prɪˈtɛnd, prɪˈtend] vt. 装扮 vi. 扮演 adj. 仿制的 
pretty	[ˈprɪti] adj. 漂亮的 adv. 相当，颇 n. 漂亮的人（或东西） 
prevail	[prɪˈveɪl, prɪˈvel] vi. 流行，盛行 
prevent	[prɪˈvent, prɪˈvɛnt] vt. 预防;阻止 vi. 阻挠，阻止 
previous	[ˈpri:viəs, ˈpriviəs] adj. 以前的;先前的 adv. 在先，在…以前 
price	[praɪs] n. 代价;价格，价钱 vt. 定价;标价 
pride	[praɪd] n. 骄傲 vt. 以…而自豪， 得意于… vi. 自豪，骄傲，得意 
priest	[pri:st, prist] n. 神甫;神父，牧师 vt. 使成为神职人员 
primary	[ˈpraɪməri, ˈpraɪmeri] adj. 首要的，主要的;最早的，原始的 n. 第一位;最好者 
prime	[praɪm] adj. 最好的 n. 精华 vt. 使准备好 adv. 极好地 vi. （为枪炮）装火药 
prince	[prɪns] n. 王子 
princess	[ˈprɪnsɪs, -ˌsɛs, prɪnˈsɛs, ˌprɪnˈses] n. 公主 
principal	[ˈprɪnsəpl, ˈprɪnsəpəl] adj. 主要的;本金的 n. 本金;首长，负责人 
principle	[ˈprɪnsəpl, ˈprɪnsəpəl] n. 原则，原理 
print	[prɪnt] n. （由底片印出的）照片 vt. （在松软的表面）压印 vt.&vi. 用印刷体写 
printer	[ˈprɪntɚ, ˈprɪntə(r)] n. 打印机 
priority	[praɪˈɒrəti, praɪˈɔ:rəti] n. 优先，优先权 
prison	[ˈprɪzn, ˈprɪzən] n. 监狱 
prisoner	[ˈprɪznə(r), ˈprɪzənɚ, ˈprɪznɚ] n. 囚犯 
privacy	[ˈpraɪvəsi, ˈprɪvəsi] n. 隐私，秘密 
private	[ˈpraɪvɪt, ˈpraɪvət] adj. 私有的，私人的;秘密的 n. 列兵，士兵，[陆]二等兵;〈古〉私人，个人 
privilege	[ˈprɪvəlɪdʒ, ˈprɪvəlɪdʒ, ˈprɪvlɪdʒ] n. 特权;（因财富和社会地位而仅有部分人享有的）权益 vt. 给与…特权，特免 
prize	[praɪz] n. 奖赏 vt. 珍视，珍惜 adj. 获奖的，有望获奖的 
probable	[ˈprɒbəbl, ˈprɑ:bəbl] adj. 可能的;大概的 n. 很可能的事;可能入选者 
probably	[ˈprɑ:bəbli, ˈprɒbəbli] adv. 大概 
problem	[ˈprɑ:bləm, ˈprɒbləm] n. 问题;疑难问题 adj. 成问题的;难处理的 
procedure	[prəˈsi:dʒə(r), prəˈsidʒɚ] n. 程序，手续 
process	[ˈproʊses, ˈprəʊses] n. 过程 vt. 处理 vi. 列队行进 adj. 经过特殊加工（或处理）的 
procession	[prəˈseʃn, prəˈsɛʃən] n. 队伍，行列;一列，一排 vi. 排队前进或列队而行 
proclaim	[prəˈkleɪm, proˈklem, prə-] vt. 表明 
produce	[prəˈdu:s, prəˈdju:s] vt.&vi. 产生 vt. 制造 n. 产品 
product	[ˈprɑ:dʌkt, ˈprɒdʌkt] n. 产品 
production	[prəˈdʌkʃn, prəˈdʌkʃən, pro-] n. 产量 
productive	[prəˈdʌktɪv, prəˈdʌktɪv, pro-] adj. 多产的 
profession	[prəˈfɛʃən, prəˈfeʃn] n. 职业，专业 
professional	[prəˈfeʃənl, prəˈfɛʃənəl] adj. 专业的;职业的 n. 专业人士 
professor	[prəˈfesə(r), prəˈfɛsɚ] n. 教授 
proficiency	[prə'fɪʃnsɪ, prəˈfɪʃənsi] n. 熟练，精通，娴熟 
profit	[ˈprɒfɪt, ˈprɑ:fɪt] n. 利润 vt. 有益于…，对…有益的 vi. 获利 
programme	[ˈprəʊgræm, ˈproˌɡræm, -ɡrəm] n. 计划 vt. 计划 vi. 编程序 
progress	[ˈprɑ:gres, ˈprəʊgres] n. 进步 v. 发展 vi. 发展 
prohibit	[prəˈhɪbɪt, proˈhɪbɪt] vt. 禁止，阻止，防止 
project	[ˈprɑ:dʒekt, ˈprɒdʒekt] vt. 计划;放映 vi. 伸出，突出 
promise	[ˈprɑ:mɪs, ˈprɒmɪs] vt. 允诺，许诺 vi. 许诺 n. 许诺 
promising	[ˈprɑ:mɪsɪŋ, ˈprɒmɪsɪŋ] adj. 有前途的 
promote	[prəˈməʊt, prəˈmoʊt] vt. 促进，推进;提升，助长 vi. 成为王后或其他大于卒的子 
prompt	[prɑ:mpt, prɒmpt] adj. 迅速的 v. 提示 n. 提示 adv. 准时地 
pronounce	[prəˈnaʊns] vt.&vi. 发音，读 vt. 宣布，宣称 vi. 宣判 
pronunciation	[prəˌnʌnsiˈeɪʃn, prəˌnʌnsiˈeʃən] n. 发音 
proof	[pru:f, pruf] n. 证明 adj. 防…的 vt. 给（织物）做防护处理，使防水（或防火等） vi. [印刷术] 校对 
proper	[ˈprɑ:pə(r), ˈprɒpə(r)] adj. 适当的，相当的，正当的，应该的，正式的，正常的 adv. 〈方〉适当地，好好地，非常，很，完完全全地，彻底地 n. [宗教][常用P-]特定节日等用的仪式，弥撒（祈祷、礼仪等）书的章节，特赞 
property	[ˈprɑ:pərti, ˈprɒpəti] n. 特性，属性 
proportion	[prəˈpɔ:ʃn, prəˈpɔ:rʃn] n. 比，比率;[数学]比例（法） vt. 使成比例;使相称 
proposal	[prəˈpoʊzl, prəˈpəʊzl] n. 建议 
propose	[prəˈpoʊz, prəˈpəʊz] vt. 求婚;提议，建议 vi. 求婚;做出计划，打算 
prospect	[ˈprɑ:spekt, ˈprɒspekt] n. 前景 vi. 勘探 vt. 找矿 
prosper	[ˈprɑ:spə(r), ˈprɒspə(r)] vi. 繁盛，成功 vt. 使…成功;使…昌盛 
prosperity	[prɒˈsperəti, prɑ:ˈsperəti] n. 繁荣 
prosperous	[ˈprɒspərəs, ˈprɑ:spərəs] adj. 富裕的 
protect	[prəˈtɛkt, prəˈtekt] vt. 保护，保卫 
protest	[ˈprəʊtest, ˈproʊtest] n. 抗议 
proud	[praʊd] adj. 自豪的，得意的 
prove	[pru:v, pruv] vt. 证明，证实;[法]验证，检定 vi. 显示出，证明是 
provide	[prəˈvaɪd] vt.&vi. 提供，供给，供应 vt. 规定 vi. 抚养，赡养(+for) 
provided	[prəˈvaɪdɪd] conj. 如果;假如 v. 提供，供给( provide的过去式和过去分词) 
province	[ˈprɑ:vɪns, ˈprɒvɪns] n. 省份 
provision	[prəˈvɪʒən, prəˈvɪʒn] n. 规定，条项，条款;预备，准备，设备 vt.&vi. 为…提供所需物品（尤指食物） 
psychology	[saɪˈkɒlədʒi, saɪˈkɑ:lədʒi] n. 心理学 
public	[ˈpʌblɪk] adj. 公开的;公众的，公共的 n. 大众;社会 
publication	[ˌpʌblɪˈkeɪʃn, ˌpʌblɪˈkeʃən] n. 出版 
publish	[ˈpʌblɪʃ] vt.&vi. 出版，发行 
pull	[ pʊl, pʊl] vt.&vi. 拉 vt. 赢得 n. 拖 
pump	[pʌmp] n. 泵 vt.&vi. 用抽水机汲水 vt. 用泵抽 
punctual	[ˈpʌŋktʃuəl] adj. 严守时刻的， 准时的，正点的 
punish	[ˈpʌnɪʃ] v. 处罚 
punishment	[ˈpʌnɪʃmənt] n. 刑罚，惩罚 
pupil	[ˈpju:pl, ˈpjupəl] n. 学生 
purchase	[ˈpɜ:tʃəs, ˈpɜ:rtʃəs] v. 购买;采购 n. 购买;购买行为 
pure	[pjʊr, pjʊə(r)] adj. 纯的;单纯的 prep. 清晰的，纯正的 
purify	[ˈpjʊrɪfaɪ, ˈpjʊərɪfaɪ] vt. 使纯净，净化 
purple	[ˈpɜ:pl, ˈpɜ:rpl] adj. 紫色的 n. 紫色 vt. 使成紫色 vi. 变紫 
purpose	[ˈpɜ:rpəs, ˈpɜ:pəs] n. 目的;意志 vt. 有意;打算 
purse	[pɜ:s, pɜ:rs] n. 钱包，钱袋;财力，财源 vt. 使皱起，噘起 
pursue	[pəˈsju:, pərˈsu:] vt. 追求;继续 vi. 追，追赶;继续进行 
pursuit	[pəˈsju:t, pərˈsu:t] n. 追赶 
push	[pʊʃ] vt.&vi. 推，推动 vt. 按 n. 推，决心 vi. 推进 
put	[pʊt] vt. 放 vt.&vi. 使感觉到 vi. 说 n. [方]笨蛋，怪人 adj. 固定的 
puzzle	[ˈpʌzəl, ˈpʌzl] vt. 使迷惑，使难解 vt.&vi. 为难，伤脑筋 n. 难题 
pyramid	[ˈpɪrəmɪd] n. 金字塔 vt. 使…成塔尖形 vi. 成金字塔状 
quality	[ˈkwɒləti, ˈkwɑ:ləti] n. 质量，品质;美质，优点 adj. 优质的，高质量的;上流社会的 
quantity	[ˈkwɒntəti, ˈkwɑ:ntəti] n. 量，数量 
quarrel	[ˈkwɔ:rəl, ˈkwɒrəl] n. 争吵，口角;反目 vi. 争辩，争吵;不同意 
quarter	[ˈkwɔ:tə(r), ˈkwɔ:rtə(r)] n. 四分之一;一刻钟 vt. 把…四等分;供…住宿 
quarterly	[ˈkwɔ:rtərli, ˈkwɔ:təli] adj. 季度的，按季度的 adv. 按季的 n. 季刊 
queen	[kwi:n, kwin] n. 女王;王后 vt. 立…为王后（或女王）;使…成为国王的妻子 
question	[ˈkwɛstʃən, ˈkwestʃən] n. 问题;疑问 vt. 问（某人）问题;对（某事物）表示[感到]怀疑 
quick	[kwɪk] adj. 快的，急速的 adv. 迅速地，快速地 n. （指甲下的）活肉 
quickly	[ˈkwɪkli, ˈkwɪklɪ] adv. 迅速地 
quiet	[ˈkwaɪət, ˈkwaɪɪt] adj. 清静的 vt.&vi. 安静下来，使…安静，平静 vt. 减轻（病痛、疑虑、恐惧等） prep. 克制的，稳重的，不张扬的 n. 宁静 adv. 安静地，平静地 
quilt	[kwɪlt] n. 被子，棉被 v. 缝（被） vt. 东拼西凑地编 vi. 缝被子 
quit	[kwɪt] vt. 离开 vi. 辞职 adj. 自由的 
quite	[kwaɪt] adv. 非常 
quiver	[ˈkwɪvə(r), ˈkwɪvɚ] vt.&vi. 微颤，抖动 vt. 使震动 n. 抖动 
quote	[kwəʊt, kwoʊt] vt.&vi. 引述，引用 vt. 报价 vi. 引用 n. 报价 
rabbit	[ˈræbɪt] n. 兔子，野兔 vi. 猎兔（通常作 go rabbiting） vt. 让…见鬼去吧 
race	[reɪs, res] n. 赛跑;民族 v. 参加比赛;使比赛 
racial	[ˈreɪʃl, ˈreʃəl] adj. 种族的 
rack	[ræk] n. 支架;行李架 vt. 使痛苦，使焦虑;剥削，榨取 
radar	[ˈreɪdɑ:(r), ˈredɑr] n. 雷达 
radical	[ˈrædɪkəl,'rædɪkḷ, ˈrædɪkl] adj. 激进的;彻底的 n. 激进分子;根基，原子团 
radio	[ˈreɪdiəʊ, ˈreɪdioʊ] n. 无线电;收音机 vt.&vi. 用无线电发送讯息;作无线电广播 
radius	[ˈrediəs, ˈreɪdiəs] n. 桡骨 
rage	[reɪdʒ] n. 愤怒;激烈，猛烈 vi. 大发脾气，动怒;流行，风行 
raid	[reɪd, red] n. （骑兵队等的）急袭，突然袭击，突击，（军舰等的）游击 vi. 对…进行突然袭击 vt. 突然袭击[抢劫] 
rail	[reɪl, rel] n. 围栏 vi. 责备 vt. 将…围起来 
railroad	[ˈreɪlroʊd, ˈreɪlrəʊd] n. 铁路，铁道;铁路系统，铁路公司 v. 迫使…仓促行事;强使…草率通过  
rain	[reɪn, ren] n. 雨;（热带地区的）雨季，雨天 vt.&vi. （雨）降下，（使）降落;大量地给，（使）大量落下 
rainbow	[ˈreɪnbəʊ, ˈreɪnboʊ] n. 彩虹 adj. 五彩缤纷的 vt.&vi. 使呈彩虹状 
raincoat	[ˈreɪnkəʊt, ˈreɪnkoʊt] n. 雨衣 
raise	[reɪz, rez] v. 筹集;提升 n. 提升;增加 
range	[reɪndʒ, rendʒ] n. 范围 vi. 搜索 vt. 排列 adj. 牧场的，放牧区的 
rank	[ræŋk] n. 军衔 vt.&vi. 排列，使成横排 vt. 排列 vi. 位于 adj. 讨厌的 
rapid	[ˈræpɪd] adj. 快速的;[摄]感光快的 n. 急流;高速交通工具，高速交通网 
rare	[reə(r), rer] adj. 罕见的，特殊的 
rarely	[ˈreəli, ˈrerli] adv. 很少地 
rat	[ræt] n. 大老鼠;似鼠动物 vi. 捕鼠;<俚>背叛，告密 
rate	[reɪt, ret] n. 速度 vt. 估价 vt.&vi. 认为，把…算作 vi. 被评价 
rather	[ˈræðər, ˈrɑ:ðə(r)] adv. 宁愿;稍微，有点 int. 当然啦，怎么不 
ratio	[ˈreɪʃiəʊ, ˈreɪʃioʊ] n. 比例;比，比率 vt. 求出比值，除，使…成比例;将（相片）按比例放大[缩小] 
rational	[ˈræʃnəl, ˈræʃənəl] adj. 理性的;合理的 n. 合理的事物;[数]有理数 
raw	[rɔ:, rɔ] adj. 生的，未加工的 vt. 擦伤 n. 原料 
ray	[reɪ, re] n. （热或其他能量的）射线;光束，光线 vt. 放射;照射 
reach	[ri:tʃ, ritʃ] v. 到达，走到;够…，抓… n. 手脚能够到的范围;范围，区域 
react	[riˈækt] vi. 反应，作出反应;影响 vt. 使发生相互作用;使起化学反应 
read	[ri:d] vt.&vi. 阅读，朗读 vt. 阅读 n. 阅读 adj. 被朗读的 
reader	[ˈri:də(r), ˈridɚ] n. 读本 
readily	[ˈredɪli, ˈrɛdəli, ˈrɛdli] adv. 乐意地 
reading	['ri:dɪŋ, ˈri:dɪŋ] n. 阅读;读数 v. 读( read的现在分词);看懂 
ready	[ˈrɛdi, ˈredi] adj. 准备好的，现成的 vt. 做好…的准备 adv. 预先 n. 现款 
real	[ˈri:əl, ˈriəl, ril] adj. 真的 adv. 真正，实在 n. 实在，现实 
realistic	[ˌriəˈlɪstɪk, ˌri:əˈlɪstɪk] adj. 现实的 
reality	[riˈæləti, riˈælɪti] n. 事实 
realization	[ˌri:əlaɪˈzeɪʃn, ˌri:ələˈzeɪʃn] n. 实现 
realize	[ˈri:əlaɪz, ˈriəˌlaɪz] vt. 实现;了解，意识到 vt.&vi. 变卖，赚得 
really	[ˈriəˌli, ˈrili, ˈri:əli] adv. 实际上 
reap	[ri:p, rip] vt.&vi. 收割 
rear	[rɪə(r), rɪr] vt. 饲养 vt.&vi. 抬起 n. 后部，背面，背后 vi. 直立 adj. 后面的，后部的 
reason	[ˈri:zn, ˈrizən] n. 原因;理由 vt.&vi. 推理，思考;争辩 
reasonable	[ˈri:znəbl, ˈrizənəbəl] adj. 合理的，公道的 
rebel	[ rɪˈbɛl, ˈrebl] n. 反叛者;叛逆者 adj. 反抗的;造反的 
recall	[rɪˈkɔl, rɪˈkɔ:l] vt. 叫回，召回;使想起，回想 n. 罢免;召回，唤回 
receipt	[rɪˈsi:t, rɪˈsit] n. 收据，发票;收入 vt. 开收据;[美国英语]给…开收据，承认收到 
receive	[rɪˈsi:v, rɪˈsiv] vt.&vi. 收到 vt. 接收 vi. 接到，获得 
recent	[ˈrisənt, ˈri:snt] adj. 最近的 
reception	[rɪˈsepʃn, rɪˈsɛpʃən] n. 接待 
reckon	[ˈrekən, ˈrɛkən] vt. 认为;计算 vi. 估计;计算 
recognition	[ˌrɛkəɡˈnɪʃən, ˌrekəgˈnɪʃn] n. 认识，识别 
recognize	[ˈrekəgnaɪz, ˈrɛkəɡˌnaɪz] vt. 承认;识别 vi. 承认，确认;[法律]具结，立保证书 
recommend	[ˌrɛkəˈmɛnd, ˌrekəˈmend] vt. 推荐;劝告 vi. 推荐;建议 
record	[ˈrekərd, ˈrekɔ:d] n. 唱片 
recorder	[rɪˈkɔ:rdə(r), rɪˈkɔ:də(r)] n. 录音机 
recover	[rɪˈkʌvə(r), rɪ'kʌvər] vt. 恢复 vi. 恢复健康（体力、能力等） n. 恢复开始时姿势 
recovery	[rɪˈkʌvəri] n. 恢复，复原 
recruit	[rɪˈkru:t, rɪˈkrut] n. 新兵 vt. 招聘，征募 vi. 征募新兵 
red	[red, rɛd] adj. 红色的;（脸）涨红的 n. 红色;红衣服 
reduce	[rɪˈdju:s, rɪˈdu:s] vt. 减少;缩小 vi. 减少;节食 
reduction	[rɪˈdʌkʃn, rɪˈdʌkʃən] n. 减少 
refer	[rɪˈfɚ, rɪˈfɜ:(r)] vi. 提到 vt. 归因于… vt.&vi. 参考，查阅 
reference	[ˈrefrəns, ˈrɛfərəns, ˈrɛfrəns] n. 参考;参考书 v. 引用;参照 
reflect	[rɪˈflɛkt, rɪˈflekt] vt.&vi. 反射（光、热、声或影像） vt. 反射，反照 vi. 反射 
reflection	[rɪˈflɛkʃən, rɪˈflekʃn] n. 反映 
reform	[rɪˈfɔ:m, rɪˈfɔ:rm] n. 改革，改良，改造 vt.&vi. 改善 vt. 改革 vi. 重组 adj. 改革的 
refrigerator	[rɪˈfrɪdʒəreɪtə(r), rɪˈfrɪdʒəˌretɚ] n. 冰箱 
refuse	[rɪˈfju:z] v. 拒绝;回绝 n. 垃圾;废弃物 
regard	[rɪˈgɑ:d, rɪˈgɑ:rd] vt. 认为 vi. 凝视 n. 凝视 
regime	[reˈʒim, rɪ-, reɪˈʒi:m] n. 政治制度，政权，政体 
region	[ˈri:dʒən, ˈridʒən] n. 地区，地域，地带 
register	[ˈrɛdʒɪstɚ, ˈredʒɪstə(r)] n. 记录 vt. 登记，注册 vi. 登记，注册 
regret	[rɪˈgret, rɪˈɡrɛt] vt. 后悔，悔恨 vi. 感到后悔，感到抱歉 n. 遗憾，惋惜 
regular	[ˈregjələ(r), ˈrɛɡjəlɚ] adj. 有规律的 n. 正规军 adv. 定期地 
reign	[reɪn, ren] vi. 当政，统治 vt. 想法、情感或氛围盛行，成为最显著的 n. 君主的统治 
reinforce	[ˌri:ɪnˈfɔ:s, ˌri:ɪnˈfɔ:rs] vt. 加固 vi. 求援 n. 加强 
reject	[rɪˈdʒekt, rɪˈdʒɛkt] vt. 拒绝;排斥 n. 被拒绝或被抛弃的人或事物 
relate	[rɪˈlet, rɪˈleɪt] vt.&vi. （把…）联系起来 vt. 讲述，叙述 vi. 涉及 
relation	[rɪˈleɪʃn] n. 关系 
relative	[ˈrɛlətɪv, ˈrelətɪv] adj. 相对的;相关的 n. 亲属，亲戚;相关物 
relativity	[ˌreləˈtɪvəti, ˌrɛləˈtɪvɪti] n. 相关性 
relax	[rɪˈlæks] vt.&vi. 放宽 vt. 缓和，减轻 vi. 变得轻松 
release	[rɪ'li:s, rɪˈli:s] vt. 释放;发布 n. 释放，排放，解除;释放令 
relevant	[ˈrɛləvənt, ˈreləvənt] adj. 有关的，中肯的 
reliable	[rɪˈlaɪəbl, rɪˈlaɪəbəl] adj. 可靠的;可信赖的 n. 可靠的人 
relief	[rɪˈli:f, rɪˈlif] n. 宽慰，安心 
relieve	[rɪˈli:v, rɪˈliv] vt. 缓解 
religion	[rɪˈlɪdʒən] n. 宗教 
religious	[rɪˈlɪdʒəs] adj. 宗教的;虔诚的 n. 修士，修女，出家人 
reluctant	[rɪˈlʌktənt] adj. 不情愿的，勉强的 
rely	[rɪˈlaɪ] vi. 依靠，倚赖，仗恃 
remain	[rɪˈmen, rɪˈmeɪn] n. 剩余物，残骸 vi. 保持 vi.&link-v. 搁置 
remainder	[rɪˈmeɪndə(r), rɪˈmendɚ] n. 剩余物 vt. 廉价出售（书） adj. 剩余的 
remark	[rɪˈmɑ:k, rɪˈmɑ:rk] n. 话语;注意，观察 vt.&vi. 评论;觉察 
remarkable	[rɪˈmɑ:kəbl, rɪˈmɑ:rkəbl] adj. 显著的 
remedy	[ˈremədi, ˈrɛmɪdi,'rɛmədɪ] n. 补救办法;治疗法 vt. 补救;治疗 
remember	[rɪˈmembə(r), rɪˈmɛmbɚ] vt.&vi. 记得;牢记 vt. 记着;纪念 
remind	[rɪˈmaɪnd] vt. 提醒 
remote	[rɪˈmoʊt, rɪˈməʊt] adj. 远程的 n. 遥控器 vt. 使…向远方延伸，把…延展到远处 
remove	[rɪˈmuv, rɪˈmu:v] vt. 去除 vi. 迁移，移居 n. 距离，差距 
render	[ˈrendə(r), ˈrɛndɚ] v. 给予 
renew	[rɪˈnu:, rɪˈnju:] vt. 补充;重新开始 vi. 重申，重复强调;重新开始 
rent	[rent, rɛnt] n. 租金 vt.&vi. 出租 adj. 撕碎的 
repair	[rɪˈpeə(r), rɪˈper] vt. 修理;纠正 n. 修理;修理工作 
repay	[rɪˈpe, rɪˈpeɪ] vt. 偿还;报答 vi. 偿还，补偿 
repeat	[rɪˈpi:t, rɪˈpit] vt. 重复 vi. 重做 n. 重复 
repetition	[ˌrɛpɪˈtɪʃən, ˌrepəˈtɪʃn] n. 重复，反复 
replace	[rɪˈples, rɪˈpleɪs] vt. 代替 
reply	[rɪˈplaɪ] n. 回答，答复 vi. [法律]（原告对被告）答辩 vt. 回应，作出反应 
report	[rɪˈpɔ:t, rɪˈpɔ:rt] n. 报告 vt.&vi. 报道 vt. 告发，举报 
reporter	[rɪˈpɔ:tə(r), rɪˈpɔ:rtə(r)] n. 记者 
represent	[ˌrɛprɪˈzɛnt, ˌreprɪˈzent] vt. 表现，象征;代表，代理 vi. 代表;提出异议 
representative	[ˌreprɪˈzentətɪv, ˌrɛprɪˈzɛntətɪv] n. 代表;继任者 adj. 有代表性的;典型的 
republic	[rɪˈpʌblɪk] n. 共和国 
republican	[rɪˈpʌblɪkən] adj. 共和国的;共和政体的 n. 拥护共和政体者，共和主义者;<美>共和党的 
reputation	[ˌrepjuˈteɪʃn, ˌrɛpjəˈteʃən] n. 名气，名声 
request	[rɪˈkwest, rɪˈkwɛst] n. 要求;需要 vt. （下级对上级的）请求;请求得到 
require	[rɪˈkwaɪə(r), rɪˈkwaɪr] vt. 需要;要求 vi. 要求，规定 
rescue	[ˈrɛskju, ˈreskju:] vt. 营救，救援，使免遭损失;[法律] 非法劫回 n. 营救，救援;营救[救援]行动 
research	[rɪˈsɜ:rtʃ, rɪˈsɜ:tʃ] n. 调查 vi. 做研究 vt. 从事…的研究，为…而做研究 
resemblance	[rɪˈzembləns, rɪˈzɛmbləns] n. 相似，形似 
resent	[rɪˈzɛnt, rɪˈzent] vt. 怨恨 
reserve	[rɪˈzɜ:v, rɪˈzɜ:rv] n. 储备 vt. 储备 vi. 预订 adj. 保留的 
reservoir	[ˈrezəvwɑ:(r), ˈrezərvwɑ:(r)] n. 蓄水池 
residence	[ˈrɛzɪdəns, ˈrezɪdəns] n. 住处，住宅 
resign	[rɪˈzaɪn, rɪ'zaɪn] v. 辞职 
resist	[rɪˈzɪst] v. 抵抗，抗拒;忍耐 n. 防染剂;防腐剂 
resistance	[rɪˈzɪstəns] n. 电阻 
resolute	[ˈrɛzəˌlut, ˈrezəlu:t] adj. 坚决的，刚毅的 
resolution	[ˌrezəˈlu:ʃn, ˌrɛzəˈluʃən] n. 分辨率 
resolve	[rɪˈzɒlv, rɪˈzɑ:lv] vt.&vi. 决心 vt. 使消释 vi. 分解 n. 决意，决定 
resource	[rɪˈsɔ:s, ˈri:sɔ:rs] n. 资源 
respect	[rɪˈspɛkt, rɪˈspekt] vt. 尊重;尊敬 n. 敬意;尊重，恭敬 
respond	[rɪˈspɒnd, rɪˈspɑ:nd] vt.&vi. 回答，响应 vi. 作出反应，响应 n. [建]（柱，拱基等的）对称，壁联 
responsibility	[rɪˌspɒnsəˈbɪləti, rɪˌspɑ:nsəˈbɪləti] n. 责任 
responsible	[rɪˈspɑ:nsəbl, rɪˈspɒnsəbl] adj. 负有责任的 
rest	[rest] n. 休息 vt.&vi. （使）休息 vi. 休息 vt. 使休息 
restaurant	[ˈrestrɒnt, ˈrestrɑ:nt] n. 餐馆 
restore	[rɪˈstɔ:(r), rɪˈstɔr, -ˈstor] vt. 修复;归还 vt.&vi. 恢复（某种情况或感受）;使复原 
restrict	[rɪˈstrɪkt] vt. 限制，限定 
restriction	[rɪˈstrɪkʃn, rɪˈstrɪkʃən] n. 限制，限定 
result	[rɪˈzʌlt] n. 结果;（尤指足球比赛的）胜利 vi. 发生，产生;归结为，导致 
retain	[rɪˈteɪn, rɪˈten] vt. 保持 
retire	[rɪˈtaɪr, rɪˈtaɪə(r)] vi. 退休 vt. 退休，退隐 n. 退休 
retreat	[rɪˈtrit, rɪˈtri:t] vi. 撤退，后退;撤销，作罢 n. 撤回;静居处 
reveal	[rɪˈvi:l, rɪˈvil] vt. 揭露;泄露 n. 揭示，展现;[建]门侧，窗侧 
revenge	[rɪˈvendʒ, rɪˈvɛndʒ] n. 报仇，报复 vt. 为…报仇，报…之仇 
revenue	[ˈrevənju:, ˈrevənu:] n. 收益 
review	[rɪˈvju:,  rɪˈvju] n. 回顾 vt. 评论 vi. 复习功课 
revolution	[ˌrevəˈlu:ʃn, ˌrɛvəˈluʃən] n. 革命 
revolutionary	[ˌrevəˈlu:ʃəneri, ˌrevəˈlu:ʃənəri] adj. 革命的;革命性的，创新的 n. 革命者，革新者 
reward	[rɪˈwɔ:d, rɪˈwɔ:rd] n. 报酬;报答 vt. 酬谢，奖赏;报答，惩罚 
rib	[rɪb] n. 肋骨;（船或屋顶等的）肋拱 vt. 嘲笑，逗弄，开（某人的）玩笑;装肋于，给…装肋材 
ribbon	[ˈrɪbən] n. 带;绶带 v. 把…撕成条带;用缎带装饰 
rice	[raɪs] n. 稻;稻米， 大米 vt. 筛选 
rich	[rɪtʃ] adj. 富有的 
rid	[rɪd] vt. 使摆脱，解除，免除 
riddle	[ˈrɪdl] n. 谜语;粗筛 v. 用筛分选（卵石等），筛分;用子弹把耙子打成蜂窝似的 
ride	[raɪd] vt.&vi. 乘，骑，驾 n. （乘坐汽车等的）旅行 vt. 搭乘 
ridge	[rɪdʒ] n. 背脊，峰，隆起线 vt. 使成脊状，使隆起 vi. 使成脊状 
ridiculous	[rɪˈdɪkjələs] adj. 可笑的，荒谬的 
rifle	[ˈraɪfəl, ˈraɪfl] n. 步枪;来福枪 vt.&vi. 快速搜寻;匆忙翻找  
right	[raɪt] adv. 立刻，马上 adj. 正确的 n. 权利 vt. 纠正 vi. （船舶等）复正，恢复平稳 
ring	[rɪŋ] n. 戒指，指环 vt. 形成环状 vi. 按铃，敲钟 
ripe	[raɪp] adj. 成熟的;醇美可口的 v. 〈诗〉同“ripen“ 
rise	[raɪz] vi. 上升 n. 兴起 vt. 使…浮上水面 
risk	[rɪsk] n. 危险，冒险;保险额 vt. 冒…的危险;使…冒风险（或面临危险） 
rival	['raɪvl, ˈraɪvl] n. 对手 vt. 与…竞争 vi. 竞争 adj. 竞争的 
river	[ˈrɪvə(r), ˈrɪvɚ] n. 河，江 
road	[rəʊd, roʊd] n. 路;通路 vt. 在…设置路障;（狗）沿臭迹追逐（猎物） 
roar	[rɔ:(r), rɔr, ror] vi. 咆哮 vt. 大声喊出 n. 吼叫声，咆哮声，呼啸声 
rob	[rɒb, rɑ:b] vt. 抢劫;抢夺，掠夺 vi. 抢劫;掠夺 
robber	[ˈrɒbə(r), ˈrɑ:bə(r)] n. 强盗，盗贼 
robbery	[ˈrɑ:bəri, ˈrɒbəri] n. 抢劫案 
robe	[roʊb, rəʊb] n. 长袍;睡袍 vt.&vi. （使）穿上长袍（或浴衣等）;覆盖、穿上 
robot	[ˈroʊbɑ:t, ˈrəʊbɒt] n. 机器人 
rock	[rɑ:k, rɒk] n. 摇滚乐 v. 摇晃 vi. 演奏摇滚乐 
rocket	[ˈrɒkɪt, ˈrɑ:kɪt] n. 火箭 vi. 飞快地移动 vt. 用火箭运送 
rod	[rɒd, rɑ:d] n. 杆，拉杆 
role	[rəʊl, roʊl] n. 作用 
roll	[rəʊl, roʊl] vt. 滚动 vi. 翻滚 n. 名册 
Roman	[ˈrəʊmən, ˈroʊmən] adj. 古罗马的;罗马人的 n. 古罗马共和国或帝国的人;罗马市民 
romance	[rəʊˈmæns, ˈroʊˈmæns] n. 恋爱;浪漫史 vt.&vi. 虚构;渲染 
romantic	[roʊˈmæntɪk, rəʊˈmæntɪk] adj. 浪漫主义的;浪漫的，谈情说爱的，多情的，风流的，香艳的 n. 富于浪漫气息的人;浪漫主义作家[画家等]，浪漫派诗人[艺术家] 
roof	[ruf,rʊf, ru:f] n. 屋顶，房屋;最高部，顶部 vt. 给…盖顶;覆盖 
room	[rum, rʊm, ru:m] n. 房间;空间 vt. 租房，合住;为…提供住处 
root	[ru:t, rut, rʊt] n. 根，根源 vt. 使生根 vi. 生根 
rope	[rəʊp, roʊp] n. 绳索 vt. （用绳子）捆 vi. 成索状或绳状 
rose	[roʊz, rəʊz] n. 玫瑰 adj. 玫瑰花的 vt. 使成玫瑰色，使（面颊）发红 v. 升起 
rotate	[rəʊˈteɪt, ˈroʊteɪt] vt.&vi. （使某物）旋转;使转动 adj. [植]辐状的;有辐射部分的 
rotten	[ˈrɑ:tn, ˈrɒtn] adj. 腐烂的;恶臭的 adv. 非常;极其 
rough	[rʌf] adj. 粗糙的，崎岖不平的 vt. 粗暴地对待 n. 粗糙的部分 adv. 粗暴地 vi. 举止粗野 
round	[raʊnd] adj. 圆形的 adv. 到处 prep. 大约 n. 圆，圆形 vt.&vi. 使成圆形 
rouse	[raʊz] v. 叫醒，惊醒 n. 觉醒 vi. 醒来 
route	[ru:t, rut, raʊt] n. 航线;路 vt. 按某路线发送;给…规定路线[次序，程序] 
routine	[ru:ˈti:n, ruˈtin] n. 常规;例行程序 adj. 常规的;例行的 
row	[roʊ, rəʊ] n. 划船;行，排 vt. 划船;使…成排 
royal	[ˈrɔɪəl] adj. 盛大的;王国的，王室的 n. <口>王室成员;[航海]顶桅帆 
royalty	[ˈrɔɪəlti] n. 版税 
rub	[rʌb] vt. 擦，摩擦 vi. 接触，摩擦 n. 摩擦的动作 
rubber	[ˈrʌbɚ, ˈrʌbə(r)] n. 橡胶 adj. 橡胶制成的 vt. 涂橡胶于 vi. 扭转脖子看 
rubbish	[ˈrʌbɪʃ] n. 垃圾;废话 vt. <英澳·非正>把…说得一钱不值，贬损…;轻视，蔑视 
ruby	[ˈrubi, ˈru:bi] n. 红宝石，红玉 adj. 红宝石的 vt. 使带红宝石色 
rude	[ru:d, rud] adj. 粗鲁的 
rug	[rʌg, rʌɡ] n. 小块地毯 
ruin	[ˈru:ɪn, ˈruɪn] vt. 破坏，毁灭 n. 毁灭，灭亡 vi. 破产 
rule	[ru:l, ruːl] n. 规则，规定 vt.&vi. 控制，支配 vt. 统治 vi. 统治 
ruler	[ˈru:lə(r), ˈrulɚ] n. 统治者 
rumor	['ru:mə, ˈrumɚ] n. <美>传闻;[古]名誉 vt. 谣传;传说 
run	[rʌn] vt.&vi. 跑 n. 奔跑 vi. （工作等）进行 vt. 使奔跑 adj. 融化的 
rural	[ˈrʊərəl, ˈrʊrəl] adj. 乡下的，农村的 
rush	[rʌʃ] vi. （使）急速行进，仓促完成 vt. 突袭 n. 冲 
Russia	['rʌʃə, ˈrʌʃə] n. (1917年以前的)俄罗斯帝国 
Russian	[ˈrʌʃən, ˈrʌʃn] adj. 俄语的;俄国的，俄罗斯的 n. 俄语;俄国人，俄罗斯人 
sack	[sæk] n. 麻袋;洗劫 vt. 解雇;把…装进袋里 
sacred	[ˈsekrɪd, ˈseɪkrɪd] adj. 神圣的 
sacrifice	[ˈsækrəˌfaɪs, ˈsækrɪfaɪs] n. 牺牲 vt.&vi. 牺牲，把…奉献给… vt. 牺牲 
sad	[sæd] adj. 悲哀的 
saddle	[ˈsædl] n. 马鞍 vt.&vi. 给（马）装鞍 vt. 使承担 
safe	[seɪf, sef] adj. 安全的;保险的，肯定的 n. 保险箱，保险柜;冷藏箱 
safeguard	[ˈseɪfgɑ:rd, ˈseɪfgɑ:d] n. 保护，保卫;防护措施 vt. 防护;保护，保卫 
safety	[ˈseɪfti, ˈsefti] n. 安全;安全性 adj. 保障安全的 
sail	[seɪl, sel] vi. 航行 vt. 航行 n. 航行 
sailor	[ˈseɪlə(r), ˈselɚ] n. 水手，海员 
saint	[seɪnt, sent] n. 圣徒;圣人般的人（指特别善良、仁爱或有耐性的人） vt. 成为圣徒;把…视为圣徒 
sake	[sek, seɪk] n. 缘故 
salad	[ˈsæləd] n. 色拉 
salary	[ˈsæləri, ˈsæləri, ˈsælri] n. 薪水，薪金，薪俸 vt. 给…加薪;给…薪水 
sale	[seɪl, sel] n. 拍卖 
salesman	[ˈselzmən, ˈseɪlzmən] n. 推销员 
salt	[sɔlt, sɔ:lt] n. 盐 vt. 撒盐 adj. 含盐的 
salute	[səˈlu:t, səˈlut] vt.&vi. 欢迎，致敬 vt. 向…致意 vi. 行礼 n. 敬礼 
same	[sem, seɪm] adj. 同一的 pron. 同一事物 adv. 同样，类似 
sample	[ˈsɑ:mpl, ˈsæmpl] n. 样品，华样 vt. 取…的样品，尤指用样品来检验 adj. 作为代表或范例的 
sand	[sænd] n. 沙;沙滩 vt. 撒沙于;用砂纸磨光 
sandwich	[ˈsænwɪtʃ, ˈsændwɪtʃ, ˈsæn-] n. 三明治;夹心面包 vt. 把…夹在…之间;把…做成三明治 
satellite	[ˈsætəlaɪt, ˈsætlˌaɪt] n. 卫星;人造卫星 v. 通过通讯卫星播送[传播] 
satire	['sætaɪər, ˈsætaɪə(r)] n. 讽刺 
satisfaction	[ˌsætɪsˈfækʃn, ˌsætɪsˈfækʃən] n. 满足，满意，舒服 
satisfactory	[ˌsætɪsˈfæktəri] adj. 令人满意的 
satisfy	[ˈsætɪsfaɪ, ˈsætɪsˌfaɪ] vt.&vi. 使满意，满足 vt. 使确信 vi. 使满足或足够 
Saturday	[ˈsætədeɪ, ˈsætərdeɪ] n. 星期六，周六 
sauce	[sɔ:s, sɔs] n. 酱汁;调味汁 vt. 调味或加沙司于…;给…增加趣味或风味 
saucer	[ˈsɔ:sə(r), ˈsɔsɚ] n. 茶杯托，茶碟 
sausage	[ˈsɒsɪdʒ, ˈsɔ:sɪdʒ] n. 香肠，腊肠 
savage	[ˈsævɪdʒ] adj. 野蛮的 vt. （动物）凶狠地攻击（或伤害） n. 未开化的人，野蛮人 
save	[seɪv, sev] vt. 保存 vi. 节省 prep.&conj. 除…之外 n. 救援，救援 
saving	[ˈseɪvɪŋ, ˈsevɪŋ] n. 节约 v. 拯救( save的现在分词) prep. 除…以外 adj. 可取的，保存的 
saw	[sɔ:, sɔ] n. 锯 vt.&vi. 往复移动 v. 看见（ see的过去式） 
say	[seɪ, se] vi. 说， 讲 vt. 表明 n. 发言权 
scale	[skeɪl, skel] n. 规模 vt. 测量 vi. 衡量 
scan	[skæn] vt. <计>扫描 n. 扫描 vi. （光束、雷达等）扫描 
scarcely	[ˈskeəsli, ˈskersli] adv. 几乎不，简直不 
scare	[sker, skeə(r)] vt. 使惊恐，惊吓 vi. 受惊吓 n. 恐慌 adj. 骇人的，令人恐惧的 
scene	[sin, si:n] n. 场面，现场 
schedule	[ˈskedʒu:l, ˈʃedju:l] n. 时刻表，进度表;清单，明细表 vt. 排定，安排;将…列表 
scheme	[skim, ski:m] vt.&vi. 策划，图谋 n. 计划 vt. 设计，计划 vi. 密谋，制定计划 
scholar	[ˈskɒlə(r), ˈskɑ:lə(r)] n. 学者 
scholarship	[ˈskɒləʃɪp, ˈskɑ:lərʃɪp] n. 奖学金 
school	[sku:l, skul] n. 学校;学院 vt. 训练，锻炼;教育，教导 
science	[ˈsaɪəns] n. 科学 
scientific	[ˌsaɪənˈtɪfɪk] adj. 科学的 
scientist	[ˈsaɪəntɪst] n. 科学家 
scissors	[ˈsɪzərz, ˈsɪzəz] n. 剪刀;两腿前后错跃 v. 剪开( scissor的第三人称单数);作剪式移动（尤指腿） 
scold	[skəʊld, skoʊld] vt. 责骂 vi. 责骂 n. 常骂人的人 
scope	[skəʊp, skoʊp] n. （处理、研究事务的）范围;眼界，见识 v. 审视，仔细研究 
score	[skɔr, skor, skɔ:(r)] n. 得分;分数 v. 评分;得分 
scorn	[skɔ:n, skɔ:rn] n. 轻蔑 vt. 蔑视 vi. 嘲笑 
scout	[skaʊt] n. 搜索，侦察 vt. 侦察 vi. 侦察 
scratch	[skrætʃ] vt. 擦，刮 vi. 发出刮擦声 n. 擦，刮 adj. 打草稿用的，随便写用的 
scream	[skri:m, skrim] vt. 尖声喊叫，拼命叫喊 vi. 尖叫 n. 尖叫声，惊叫声 
screen	[skri:n, skrin] n. 屏幕;银幕 vt. 掩藏;庇护 
screw	[skru:, skru] n. 螺丝钉 vt. 用螺丝拧紧 vi. 扭转，扭歪 
sea	[si:] n. 海 
seal	[si:l, sil] n. 密封;印章 v. 密封;盖章 
seam	[si:m, sim] n. 煤层 vt. 缝合，接合 vi. 裂开，发生裂痕 
search	[sɜ:tʃ, sɜ:rtʃ] v. 搜查;搜寻，搜索 n. 搜索;调查 
seaside	[ˈsi:saɪd, ˈsiˌsaɪd] n. 海滨;海边 adj. 海边的;海滨的 
season	[ˈsizən, ˈsi:zn] n. 季节，季 vt. 使适应，使适用 vt.&vi. 使变干燥 
seat	[si:t, sit] n. 所在地;席位，座位 vt. 使就座;使就职 
second	[ˈsekənd] n. 秒 adj. 第二的 adv. 第二 vt. 支持 
secondary	[ˈsekəndri, ˈsekənderi] adj. 第二的，中等的;助手，副手 n. 副手，代理人;[天]双星中较小较暗的一个，卫星 
secret	[ˈsi:krət, 'si:krət] n. 秘诀;奥秘 adj. 隐秘的;神秘的 
secretary	[ˈsekrəteri, ˈsekrətri] n. 秘书 
section	[ˈsekʃn,  ˈsɛkʃən] n. 部分 vi. 切开 vt. 把…切成片（或段） 
secure	[sɪˈkjʊə(r), səˈkjʊr] adj. 安全的 vt. 保护 vi. 获得安全，变得安全 
security	[sɪˈkjʊərəti, səˈkjʊrəti] n. 安全;保证，担保 adj. 安全的，保安的，保密的 
see	[si:, si] vt.&vi. 看见;查看 n. 主教教区;主教权限 
seed	[si:d, sid] n. 种子 vt. 播种 vi. 结籽 
seek	[sik, si:k] vt. 寻找，探寻;追求，谋求 vi. 查找，查寻;找一找 
seem	[si:m, sim] v. 似乎 
seize	[siz, si:z] vt.&vi. 抓住;逮捕 vt. 夺取;占领 
seldom	[ˈseldəm, ˈsɛldəm] adv. 难得 
select	[sɪˈlekt, sɪˈlɛkt] vt. 选择;挑选 adj. 精选的;挑选出来的 
selection	[sɪˈlɛkʃən, sɪˈlekʃn] n. 选择 
self	[self, sɛlf] n. 自己 adj. 同一的 vt. 使自花授精 vi. 自花授精 
selfish	[ˈselfɪʃ, ˈsɛlfɪʃ] adj. 自私的，利己的 
sell	[sɛl, sel] vt.&vi. 销售 vt. 推销 n. 销售 vi. 卖 
semiconductor	[ˌsemikənˈdʌktə(r), sɛmikənˈdʌktɚ] n. <物>半导体 
seminar	[ˈsemɪnɑ:(r), ˈsɛməˌnɑr] n. 研讨会 
senate	[ˈsenət, ˈsɛnɪt] n. 参议院（美国、法国、澳大利亚等国家的两个立法机构之一） 
senator	[ˈsenətə(r), ˈsɛnətɚ] n. 参议员 
send	[send, sɛnd] vt. 送 vt.&vi. 用无线电波发送，发出信息 vi. 派遣，发出，派人 adj. [仅用作定语]用于发送的 
senior	[ˈsinjɚ, ˈsi:niə(r)] adj. 资深的;（级别、地位等）较高的 n. 上级;<美>毕业班学生 
sense	[sɛns, sens] n. 感觉，官能;意识，观念 vt. 感到;理解，领会 
sensible	[ˈsensəbl, ˈsɛnsəbəl] adj. 明智的;通情达理的 n. 可感觉到的东西;敏感的人 
sentence	[ˈsentəns, ˈsɛntəns] n. 句子;宣判 vt. 宣判，判决 
separate	[ˈseprət, 'sepəreɪt] vt.&vi. 分开 vt. 分离（混合物） vi. 分手 
September	[sepˈtembə(r), sɛpˈtɛmbɚ] n. 九月 
series	[ˈsɪri:z, ˈsɪəri:z] n. 串联 
serious	[ˈsɪəriəs, ˈsɪriəs] adj. 严肃的，严重的 
servant	[ˈsɜ:vənt, ˈsɜ:rvənt] n. 仆人，佣人，雇工 
serve	[sɜ:v, sɜ:rv] vt.&vi. 提供 vt. 招待 vi. 适合 n. 网球等发球 
service	[ˈsɜ:rvɪs, ˈsɜ:vɪs] n. 服役 vt. 检修，维修 adj. 服务性的 
session	[ˈseʃn, ˈsɛʃən] n. 开会，会议 
set	[sɛt, set] vt. 放置，安置 vi. 落山 n. 一套，一副 adj. 固定的 
setting	[ˈsetɪŋ, ˈsɛtɪŋ] n. 环境;镶嵌 v. 放( set的现在分词);安插 
settle	[ˈsetl, ˈsɛtl] vt. 解决 vi. 定居 n. 高背长靠椅 
settlement	[ˈsɛtlmənt, ˈsetlmənt] n. 结算 
seven	[ˈsɛvən, ˈsevn] num. 七;七个 n. 七;七个 
seventeen	[sev(ə)nˈtin, ˌsevnˈti:n] n. 十七 adj. 十七岁的 num. 十七 
seventh	[ˈsevnθ, ˈsɛvənθ] n. 第七（个） adj. 第七的 adv. 居第七位地 
seventy	[ˈsɛvənti, ˈsevnti] n. 七十 
several	[ˈsɛvərəl,ˈsɛvrəl, ˈsevrəl] adj. 几个的;专有的 pron. 一些;几个，数个 
severe	[sɪˈvɪə(r), sɪˈvɪr] adj. 严峻的 
sew	[səʊ, soʊ] vt.&vi. 缝纫 
sex	[sɛks, seks] n. 性别;两性之一 vt. 辨识性别;引起性欲 
shade	[ʃeɪd, ʃed] n. 遮阳，遮棚 vt. 遮蔽 vi. 逐渐变化 
shadow	[ˈʃædoʊ, ˈʃædəʊ] n. 阴影 vt. 投阴影于 vi. 渐变 adj. 阴影的 
shake	[ʃek, ʃeɪk] vt. 动摇 vi. 握手 n. 震动 
shall	[ʃæl, ʃəl] v. 必须 
shallow	[ˈʃæloʊ, ˈʃæləʊ] adj. 浅的，肤浅的 n. 浅处 v. 使变浅 
shame	[ʃem, ʃeɪm] n. 羞愧;羞辱 vt. 使蒙羞;玷辱 
shape	[ʃeɪp, ʃep] n. 形状 vt. 塑造 vi. 形成 
share	[ʃeə(r), ʃer] n. 股 vt.&vi. 共用 vt. 分配 vi. 分享，分担(in) 
shark	[ʃɑ:k, ʃɑ:rk] n. 鲨鱼 v. 骗取 vi. 诈骗 
sharp	[ʃɑ:p, ʃɑ:rp] adj. 锋利的 adv. 猛烈地 n. 升半音 vt. [音乐]把（音调）升高（半音） vi. [音乐]升音演奏（或演唱） 
shave	[ʃeɪv, ʃev] vt.&vi. 剃须，剃毛 vt. 剃，削去 n. 修面 
she	[ʃi] pron. 她，它 
shed	[ʃed] n. 棚，库 vt. 流下 vi. 脱落 
sheep	[ʃi:p, ʃip] n. 羊，绵羊 
sheet	[ʃi:t, ʃit] n. 纸 vt. 用（床单等）包裹 vi. 成片展开，成片流动 adj. （金属材料）制成薄板（或薄片）的，扎制成片的，片状的 
shelf	[ʃelf, ʃɛlf] n. 架子，搁板 
shell	[ʃɛl, ʃel] n. 外壳 vt. 去壳，脱落 vi. 剥皮 
shelter	[ˈʃeltə(r), ˈʃɛltɚ] n. 避难所 vt. 庇护 vi. 避难 
shepherd	[ˈʃepəd, ˈʃepərd] n. 牧羊人，羊倌;牧师 vt. 带领，引导;牧（羊），放牧 
shield	[ʃi:ld, ʃild] n. 盾;护罩 vt. 保护;掩护 
shift	[ʃɪft] vt.&vi. 改变 vt. 换…的衣服，更（衣） vi. （汽车）换挡 n. 移动，转移，转换 
shine	[ʃaɪn] vi. 发出光 vt. 照射，把光射后 n. 光亮，光泽 
ship	[ʃɪp] n. 船 vt.&vi. 运送 vt. 把…装上船 vi. 在船上工作 
shirt	[ʃɜ:t, ʃɜ:rt] n. 衬衫，衬衣 
shiver	[ˈʃɪvɚ, ˈʃɪvə(r)] n. 发抖，颤抖 vi. 战栗，发抖 vt. 由于航行时太靠近风而使（帆）颤动 
shock	[ʃɒk, ʃɑ:k] n. 休克 vt. 使休克 vi. 感到震惊 adj. 浓密的 
shoe	[ʃu:, ʃu] n. 鞋;蹄铁 vt. 为…钉蹄铁;给…穿上鞋 
shoot	[ʃu:t, ʃut] vi. 拍摄 vt. 拍摄 n. 幼苗，嫩芽 int. 感叹词（用于表示惊奇，并不强烈的愤怒或失望） 
shop	[ʃɒp, ʃɑ:p] n. 商店 vt.&vi. （到…）去买东西[购物] vt. 购物 
shop-assistant	['ʃɒp-əsɪstənt] n. 商店售货员 
shopkeeper	[ˈʃɒpki:pə(r), ˈʃɑ:pki:pə(r)] n. 店主，老板 
shopping	[ˈʃɑ:pɪŋ, ˈʃɒpɪŋ] n. 购物，买东西 vi. 选购：为寻找商品或便宜货而逛商店 vt. 逛（某一个商店）或（在某一个商店）买东西 
shore	[ʃɔ:(r), ʃɔr, ʃor] n. 岸;滨 vt. 支撑;支持 
short	[ʃɔ:t, ʃɔ:rt] adj. 短期的 adv. 突然 n. 短路 vt. 故意少给…的零头，骗取 vi. 短路 
shortage	[ˈʃɔ:tɪdʒ, ˈʃɔ:rtɪdʒ] n. 缺少 
shortcoming	[ˈʃɔ:tkʌmɪŋ, ˈʃɔ:rtkʌmɪŋ] n. 短处，缺点 
shortcut	['ʃɔ:tkʌt, ˈʃɔrtˌkʌt] n. 捷径，近路 
shortly	[ˈʃɔ:rtli, ˈʃɔ:tli] adv. 立刻，马上 
shot	[ʃɒt, ʃɑ:t] n. 射手，击球 adj. 闪色的，颜色会变化的 vt. 射中，射击 vi. 发射，射击 v. 射杀 
should	[ʃʊd]  应该 
shoulder	[ˈʃoʊldə(r), ˈʃəʊldə(r)] n. 肩膀;（衣服的）肩部 vt. 担负，承担;肩起，挑起 
shout	[ʃaʊt] vt.&vi. 呼喊，叫喊;高声说或发出喊叫声 n. 大叫;呐喊 
show	[ʃəʊ, ʃoʊ] vt.&vi. 表现出 vt. 表明 n. 显示 vi. 被人看见，显现，显而易见 
shower	[ˈʃaʊə(r), ˈʃaʊɚ] n. 淋浴 vi. 下阵雨 vt. 大量地给予 
shrink	[ʃrɪŋk] vt.&vi. 收缩，皱缩;（使）缩水 n. 收缩;畏缩 
shut	[ʃʌt] vt.&vi. 关闭;闭上 adj. 关闭;关门 
shy	[ʃaɪ] adj. 害羞的 vi. 惊退，畏缩 n. 投掷 
sick	[sɪk] adj. 恶心的 vt. 吐出 n. 病人 
side	[saɪd] n. 侧面 adj. 侧面的 vi. 支持，同意 
sigh	[saɪ] vi. 叹气 vt. 叹气地说 n. 叹气，叹气声 
sight	[saɪt] n. 景象 vt. 瞄准 vi. （用仪器）瞄准 
sightseeing	[ˈsaɪtsi:ɪŋ, ˈsaɪtˌsiɪŋ] n. 观光，游览 
sign	[saɪn] n. 迹象;符号 vt.&vi. 签名;打手势 
signal	[ˈsɪgnəl, ˈsɪɡnəl] n. 信号，暗号 vt. 向…发信号 vi. 发信号 adj. 显著的，优越的 
signature	[ˈsɪɡnətʃɚ, ˈsɪgnətʃə(r)] n. 签名 
significance	[sɪgˈnɪfɪkəns, sɪɡˈnɪfɪkəns] n. 意义 
significant	[sɪgˈnɪfɪkənt, sɪɡˈnɪfɪkənt] adj. 重要的;有意义的 n. 有意义的事物;象征，标志 
silence	[ˈsaɪləns] n. 沉默，无言，无表示，无声，沉静，肃静，寂静，缄默;无音信，失去联系，忘却，湮没，无表示，无音讯 vt. 使安静;使沉默 
silent	[ˈsaɪlənt] adj. 沉默的，无言的;寂静的，无声的 n. 无声电影 
silk	[sɪlk] n. 丝，蚕丝 vi. （玉米）处于长须的阶段中 adj. 丝绸的 
silly	[ˈsɪli] adj. 蠢的;糊涂的 n. （常用于向孩子指出其愚蠢行为）傻孩子，淘气鬼;傻子，蠢货 
silver	[ˈsɪlvɚ, ˈsɪlvə(r)] n. 银 adj. 银色的 vt. （在某物上）镀银 
similar	[ˈsɪməlɚ, ˈsɪmələ(r)] adj. 相似的;类似的 n. 类似物;相像的人 
simple	[ˈsɪmpl, ˈsɪmpəl] adj. 简单的;单纯的 n. 笨蛋;愚蠢的行为 
simply	[ˈsɪmpli] adv. 简直 
sin	[sɪn] n. 违背宗教[道德原则]的恶行 vi. 犯罪，犯过错 vt. 犯罪 
since	[sɪns] prep. 自从 adv. 以后，此后 conj. 因为 
sincere	[sɪnˈsɪə(r), sɪnˈsɪr] adj. 真诚的，诚挚的 
sing	[sɪŋ] vt.&vi. 唱，歌唱，吟诵 vi. （鸟）鸣 v. 耳鸣 n. 呜呜声，嗖嗖声 
single	[ˈsɪŋgl, ˈsɪŋɡəl] adj. 单一的 n. 单程票 vt. 挑选 vi. 作一垒手 
singular	[ˈsɪŋgjələ(r), ˈsɪŋɡjəlɚ] adj. 奇特的;非凡的 n. 单数形式（的词） 
sink	[sɪŋk] vi. 淹没 vt. 使下沉 n. 水池 
sir	[sɜ:(r), sɚ] n. 先生 
siren	[ˈsaɪrən] n. 汽笛 
sister	[ˈsɪstə(r), ˈsɪstɚ] n. 姐妹 adj. 姐妹般的 v. 如姐妹般相待 
sit	[sɪt, sit] vt.&vi. （使）坐 vi. 坐落 vt. 使就座 
site	[saɪt] n. 遗址;地点，位置，场所 vt. 使坐落在;安放，设置 
situation	[ˌsɪtʃuˈeʃən, ˌsɪtʃuˈeɪʃn] n. （人的）情况 
six	[sɪks] n. 六;六个 num. 六;六个 
sixteen	[ˌsɪksˈti:n, sɪkˈstin] n. 十六，十六个 num. 十六 adj. 十六的 
sixth	[sɪksθ,  sɪksθ] pron. 第六;第六感觉 n. （英国中学的最高年级）六年级;[乐]六度音程 
sixty	[ˈsɪksti] num. 六十 
size	[saɪz] n. 规模 vt. 按大小排列 adj. 一定尺寸的 
skate	[skeɪt, sket] vt.&vi. 溜冰，滑冰 n. 溜冰鞋 
skeleton	[ˈskelɪtn, ˈskɛlɪtn] n. 骨骼;（建筑物等的）骨架 adj. 骨骼的;骨瘦如柴的 
sketch	[skɛtʃ, sketʃ] n. 素描;草图 v. 速写;草拟 
ski	[ski:, ski] n. 滑雪;滑雪板 v. 滑雪，滑冰 
skill	[skɪl] n. 技能，技巧 
skilled	[skɪld] adj. 熟练的，有技能的 
skin	[skɪn] n. 皮，皮肤 vt. 剥皮，削皮 vi. 使愈合，长皮 adj. <俚>色情的 
skirt	[skɜ:t, skɜ:rt] n. 裙子;边缘 vt.&vi. 位于…的边缘;沿…的边缘走 
sky	[skaɪ] n. 天（空） vt. 将…击向空中;将…高挂 
skyscraper	[ˈskaɪskreɪpə(r), ˈskaɪˌskrepɚ] n. 摩天大楼，超高层大楼 
slack	[slæk] adj. 懈怠的 v. 懈怠 n. 宽松裤 
slap	[slæp] n. 掌掴 vt. 猛打 vi. 拍击 adv. 直接地 
slave	[sleɪv, slev] n. 奴隶;…。的奴隶，耽迷于…的人 vi. 奴隶般地工作，做苦工;买卖奴隶，运输奴隶 
slavery	[ˈslevəri, ˈslevri, ˈsleɪvəri] n. 奴隶制度 
sleep	[sli:p, slip] vi.&link-v. 睡，睡觉 vi. 睡，睡觉 vt. 为…提供床位 n. 睡眠 
sleeve	[sli:v, sliv] n. [机]套筒，套管;袖子，袖套 vt. 给…装袖子;给…装套筒 
slender	[ˈslendə(r), ˈslɛndɚ] adj. 苗条的 
slice	[slaɪs] vt. 切成片 n. 薄片 vi. 斜击 
slide	[slaɪd] vi. 滑落 vt. 衰落（成） n. 幻灯片 
slight	[slaɪt] adj. 微小的 n. 轻蔑，忽视，冷落 vt. 轻蔑，忽视，怠慢 
slightly	[ˈslaɪtli] adv. 轻微地，轻轻地 
slip	[slɪp] vi. 滑，滑脱 vt. 使顺利滑动 n. 跌倒，失足 adj. 滑动的 abbr. 串行线路接口协议(Serial Line Interface Protocol) 
slipper	[ˈslɪpə(r), ˈslɪpɚ] n. 拖鞋，（室内）便鞋;（马车的）煞车，[机]滑动部分，滑屐 v. （用拖鞋）打（孩子等）;穿着拖鞋走 
slippery	[ˈslɪpəri] adj. 滑溜的 
slogan	[ˈsləʊgən, ˈsloʊgən] n. 标语，口号 
slope	[sləʊp, sloʊp] n. 斜坡 vi. 倾斜 vt. 使倾斜 
slow	[sləʊ, sloʊ] adj. 慢的 adv. 慢慢地 vt.&vi. （使）缓行，（使）减速 vi. 变慢 vt. 放慢 
slum	[slʌm] n. 贫民窟，贫民区 vi. （因好奇而）逛贫民区 
sly	[slaɪ] adj. 狡猾的，狡诈的 
small	[smɔl, smɔ:l] adj. 小的 adv. 小小地 n. 细小部分，腰部 
smart	[smɑ:rt, smɑ:t] adj. 聪明的 vi. 疼痛 n. 创伤 vt. 引起…的疼痛（或痛苦、苦恼等） adv. 聪明伶俐地，轻快地，漂亮地 
smell	[smel, smɛl] n. 气味;嗅觉 vt.&vi.&link-v. 嗅，闻;闻出，发觉，查出 
smile	[smaɪl] n. 微笑，笑容 vt. 以微笑表示 vi. 微笑 
smoke	[smoʊk, sməʊk] n. 烟 vi. 抽烟 vt. 用烟熏制 
smooth	[smuð, smu:ð] adj. 光滑的 vt. 使平滑 vi. 变平和，变缓和 n. 平地，平面 
smuggle	[ˈsmʌgl, ˈsmʌɡəl] vt. 走私;偷运 vi. 走私;偷带 
snack	[snæk] n. 快餐，点心;加餐 vi. 吃快餐 
snake	[snek, sneɪk] n. 蛇 vt. 沿…曲折前进（或延伸） vi. 曲折前进（或延伸） 
snatch	[snætʃ] n. 抢 vi. 作出握住或抢夺的动作 vt. 抢夺，夺得 
snow	[snəʊ, snoʊ] n. 积雪 vt. 下雪 vi. 降雪 
so	[səʊ, soʊ] adv. 这样 conj. （表示因果关系）因此 pron. 如此 int. [表示同意、赞成等] 好啦，就这样吧！停下！（停住）别动！ adj. 如此的 
soak	[səʊk, soʊk] vt. 浸泡，浸透 vi. 浸泡 n. 湿透 
sob	[sɒb, sɑ:b] vi. 呜咽 vt. 哭诉，呜咽着说 n. 啜泣（声），呜咽（声） 
social	[ˈsoʊʃl, ˈsəʊʃl] adj. 社会的，社会上的;交际的，社交的 n. 联谊会，联欢会;社交聚会 
socialist	[ˈsəʊʃəlɪst, ˈsoʊʃəlɪst] n. 社会主义者 adj. 社会主义的;社会党的 
society	[səˈsaɪɪti, səˈsaɪəti] n. 社会;社团 adj. 上流社会的，社交界的 
sock	[sɒk, sɑ:k] n. 短袜;（尤指用拳头）猛击，重击 vt. 重击;给…穿袜 
soda	[ˈsəʊdə, ˈsoʊdə] n. 苏打 
soft	[sɒft, sɔ:ft] adj. 软的，柔软的 n. 柔软之物，柔软的部分 adv. 柔和地 
software	[ˈsɒftweə(r), ˈsɔ:ftwer] n. 软件 
soil	[sɔɪl] n. 泥土 vt. 弄脏，污辱 vi. 变脏、受污染或玷污的 
soldier	[ˈsoʊldʒə(r), ˈsəʊldʒə(r)] n. 士兵;战士 v. 坚持;硬挺着 
sole	[soʊl, səʊl] adj. 惟一的 n. 鞋底 vt. 给（鞋）换底 
solemn	[ˈsɑ:ləm, ˈsɒləm] adj. 庄重的 
solid	[ˈsɑ:lɪd, ˈsɒlɪd] adj. 固体的;实心的 n. 固体;立体图形 
solidify	[səˈlɪdəˌfaɪ, səˈlɪdɪfaɪ] vt.&vi. 使凝固，固化 vt. 凝固 vi. 凝固 
solution	[səˈlu:ʃn, səˈluʃən] n. 溶液 
solve	[sɒlv, sɑ:lv] vt. 解决 
some	[sʌm, səm] adj. 一些 pron. 一些 adv. 非常 
somebody	[ˈsʌmˌbɑdi, -ˌbʌdi, -bədi, ˈsʌmbədi] pron. 某人，有人 n. 大人物，重要的人物 
somehow	[ˈsʌmhaʊ, ˈsʌmˌhaʊ] adv. 以某种方式，用某种方法 
someone	[ˈsʌmwʌn, ˈsʌmˌwʌn, -wən] pron. 某人，有人 n. 某个人 
something	[ˈsʌmθɪŋ] pron. 某物，某事 n. （表示不确切的描述或数量）大致，左右 adv. 非常 
sometime	[ˈsʌmtaɪm, ˈsʌmˌtaɪm] adv. 将来某个时候;过去某个时候 adj. （指某人曾经是…）从前的，一度的;某一时间的 
sometimes	[ˈsʌmtaɪmz, ˈsʌmˌtaɪmz] adv. 时而 
somewhat	[ˈsʌmwɒt, ˈsʌmwʌt] adv. 稍微;有点 n. 少量;某些数量 
somewhere	[ˈsʌmwer, ˈsʌmweə(r)] adv. 某地 
son	[sʌn] n. 儿子 
song	[sɒŋ, sɔ:ŋ] n. 歌曲 
soon	[su:n, sun] adv. 快 
sore	[sɔr, sor, sɔ:(r)] adj. 疼痛的 n. （肌肤的）痛处，伤处 adv. 〈古，诗〉同sorely 
sorrow	[ˈsɒrəʊ, ˈsɑ:roʊ] n. 悲痛;悔恨，惋惜 vt.&vi. 悲痛;遗憾 
sorry	[ˈsɒri, ˈsɑ:ri] adj. 遗憾的 
sort	[sɔ:t, sɔ:rt] n. 分类，类别 vt.&vi. 分类 vt. 挑选 vi. 分类 
soul	[soʊl, səʊl] n. 灵魂;精神 adj. 美国黑人文化的 
sound	[saʊnd] n. 声音，声响 vi. 响，发声 vt. 使出声，使发声 adj. 健全的 adv. 彻底地，充分地 
soup	[su:p, sup] n. 汤，羹;浓雾 vt. 加大马力 
sour	[saʊr, ˈsaʊə(r)] adj. 有酸味的 vi. 变酸，变馊 vt. 变坏，恶化 n. 酸味 
source	[sɔ:rs, sɔ:s] n. 根源，本源 vt. （从…）获得 vi. 原料来源 
south	[saʊθ] n. 南方 adj. 南的 adv. 向南方，在南方 
southern	[ˈsʌðərn, ˈsʌðən] adj. 南方的，南部的;来自南方的 n. 南方人，南部人 
southward	[ˈsaʊθwəd, ˈsʌðəd, 'saʊθwəd] adv.&adj. 向南方（的） 
sow	[səʊ, soʊ] vt.&vi. 播（种），播种于 vt. 散布 n. 母猪 
space	[speɪs,  spes] n. 空间，太空 vt. 把…分隔开，留间隔于…之间 vi. 以一定间隔排列 
spaceship	[ˈspeɪsʃɪp, ˈspesˌʃɪp] n. （尤指小说中的）宇宙飞船 
spade	[sped, speɪd] n. 铁锹，铲子;纸牌中的)黑桃 vt. 铲 
Spanish	[ˈspænɪʃ] adj. 西班牙的;西班牙语的 n. 西班牙语;西班牙人 
spare	[speə(r), sper] vt. 节省，俭省 adj. 多余的，剩下的（钱等），空闲的（时间等） n. 备用零件，备用轮胎 vi. 节约 
spark	[spɑ:k, spɑ:rk] n. 电火花 vi. 发出火星，发出闪光 vt. 发动，触发 
sparkle	[ˈspɑ:kl, ˈspɑ:rkl] vi. 闪耀，闪烁;活跃，焕发活力和才智 n. 光亮;活力 
sparrow	[ˈspærəʊ, ˈspæroʊ] n. 麻雀 
speak	[spi:k, spik] vt.&vi. 讲，谈 
speaker	[ˈspikɚ, ˈspi:kə(r)] n. 扬声器 
spear	[spɪə(r), spɪr] n. 矛 vt. 用矛刺 adj. 父系的，右边的 
special	[ˈspɛʃəl, ˈspeʃl] adj. 特殊的;专用的 n. 专车;特价 
specific	[spəˈsɪfɪk, spɪˈsɪfɪk] adj. 具体的;明确的 n. 特效药;特性 
spectator	[spekˈteɪtə(r), ˈspekteɪtər] n. 观众，旁观者 
speech	[spi:tʃ, spitʃ] n. 演说，演讲，发言 
speed	[spid, spi:d] n. 速度 vt.&vi. 急行，加速 vi. 加速 vt. 加快…的速度 
spell	[spɛl, spel] vt. 拼写 vi. 轮替 n. 符咒，咒语 
spend	[spɛnd, spend] vt.&vi. 用钱，花钱 vt. 花费 n. （为某目的或某段时间内的）花销，花费，开销 
sphere	[sfɪə(r), sfɪr] n. 球（体）;（兴趣或活动的）范围 vt. 形成球体;包围，围绕 
spin	[spɪn] vi. 纺纱 vt. 纺（线） n. 旋转的行为 
spirit	[ˈspɪrɪt] n. 精神，心灵;情绪 v. 神秘地带走 
spite	[spaɪt] n. 怨恨;恶意 vt. 向…表示恶意;欺负 
splendid	[ˈsplendɪd, ˈsplɛndɪd] adj. 壮观的，豪华的 
split	[splɪt] vt. 分裂 n. 划分 vi. <俚>走开 adj. 裂开的，劈开的，分离的，分裂的 
spoil	[spɔɪl] vi. 变质 vt. 损坏，糟蹋 n. 抢劫，掠夺 
sponsor	[ˈspɑ:nsə(r), ˈspɒnsə(r)] n. 发起者，主办者;担保者 vt. 赞助 
spoon	[spu:n, spun] n. 匙，调羹 vt. 用汤匙舀取 vi. 轻轻向上击 
sport	[spɔ:t, spɔ:rt] n. 体育运动;乐趣 v. 得意地穿戴;夸示 
sportsman	[ˈspɔ:rtsmən, ˈspɔ:tsmən] n. 运动员，运动家 
spot	[spɒt, spɑ:t] n. 地点，场所 v. 弄上污渍，弄上斑点 adj. 现场的 abbr. satellite positioning and tracking 卫星定位和跟踪 
spread	[spred, sprɛd] vt.&vi. 展开 n. 范围 vt. 涂 vi. （景色、景致）展现 adj. 张开的 
spring	[sprɪŋ] n. 春季 vi. 跳，跃 vt. 突然跳出 adj. 春天的 
spy	[spaɪ] n. 间谍 vt. 看见 vi. 当间谍 
square	[skwer, skweə(r)] n. 平方 adj. 平方的 adv. 四四方方地 vt. 使成正方形 vi. 一致 
squeeze	[skwi:z, skwiz] vt.&vi. 挤，榨，捏 vt. 榨取，汲取 vi. 在强压下屈服 n. 挤压，压榨 
squirrel	[ˈskwɪrəl, ˈskwɜ:rəl] n. 松鼠，松鼠科动物;松鼠毛皮 vt. 储藏;贮存 
stable	[ˈstebəl, ˈsteɪbl] adj. 稳定的 n. 厩，马厩，马棚，牛棚 vt. 使关进畜舍（或马厩、牛棚等），使放入马厩般的室内 vi. 被关在畜舍内，（人）生活在厩一般的地方 
staff	[stɑ:f, stæf] n. 参谋 adj. 职员的 v. 在…工作 
stage	[stedʒ, steɪdʒ] n. 阶段 vt.&vi. 上演，演出 vt. 举行 vi. 适于上演，适合在舞台上演出 
stair	[ster, steə(r)] n. 楼梯 
staircase	[ˈsterkeɪs, ˈsteəkeɪs] n. 楼梯 
stamp	[stæmp] n. 邮票 vt. 标记 vi. 捣碎 
stand	[stænd] n. 立场 vi. 站立，起立 vt. 忍受 vt.&vi. 站立，（使）直立，站着 
standard	[ˈstændərd, ˈstændəd] n. 标准，规格;旗，军旗 adj. 标准的，合格的;普遍的，一般的 
star	[stɑr, stɑ:(r)] n. 明星;星 v. 主演;（在文字等旁）标星号 
stare	[ster, steə(r)] vi. 盯着看 vt. 凝视 n. 凝视，瞪视 
start	[stɑ:t, stɑ:rt] n. 开始 vt.&vi. 出发，启程 vt. 起动 vi. 起始 
startle	[ˈstɑ:rtl, ˈstɑ:tl] vt. 使震惊，使大吃一惊 vi. 惊吓 n. 惊跳 
starve	[stɑ:rv, stɑ:v] vi. 挨饿;[非正式用语] 饥饿 vt. 饿死;使挨饿 
state	[steɪt, stet] n. 国家 vt. 规定 adj. 国家的 
statement	[ ˈstetmənt, ˈsteɪtmənt] n. 声明 vi. （英国）对儿童进行特殊教育评估认定 vt. 申请（小孩）有特殊教育需要 
statesman	[ˈsteɪtsmən, ˈstetsmən] n. 政治家 
station	[ˈsteʃən, ˈsteɪʃn] n. 车站;所，局 vt. 配置，安置;驻扎 
statue	[ˈstætʃu, ˈstætʃu:] n. 雕像，塑像 vt. 用雕像装饰 
status	[ˈstetəs, ˈstætəs, ˈsteɪtəs] n. 地位 
stay	[steɪ, ste] vt.&vi. 停留 vi. 继续处于某种状态 n. 逗留 
steady	[ˈstedi, ˈstɛdi] adj. 稳定的，不变的 vt. 使稳定，使坚定 n. 关系固定的情侣 
steal	[sti:l, stil] vt. 偷 vi. 偷 n. 偷窃 
steam	[sti:m, stim] n. 蒸汽，雾 vt.&vi. 冒蒸汽 vi. 动力 vt. 蒸煮 
steep	[sti:p, stip] adj. 陡峭的，险峻的 vt. 浸泡 vi. 在液体中浸泡 n. 泡的行为或过程 
steer	[stɪə(r), stɪr] vt.&vi. 引导 vt. 掌（舵） vi. 行进 n. 阉公牛，肉用公牛 
stem	[stɛm, stem] n. （花草的）茎;词干 vt. 阻止;遏制[阻止]（液体的流动等） 
step	[stɛp, step] n. 步，脚步 vt.&vi. 举步，行走 vi. 走 vt. 跳舞 
stern	[stɜ:rn, stɜ:n] adj. 严肃的;严厉的，严峻的 n. 船尾，艉;末端 
stick	[stɪk] vt.&vi. 粘贴 vt. 容忍 n. 棍棒，棍枝 
stiff	[stɪf] adj. 严厉的 adv. <口>极度地，非常 n. 死尸 vt. 诈骗 
still	[stɪl] adv. 仍，仍然 adj. 不动的，静止的 n. 平静，寂静 vt.&vi. （使某物）平静下来，安静 conj. 但是 
sting	[stɪŋ] vt. 刺痛 vi. 感到剧痛 n. 螫伤处 
stir	[stɚ, stɜ:(r)] vt.&vi. 搅拌 vt. 使打起精神 vi. 苏醒 n. 搅动 
stock	[stɒk, stɑ:k] n. 库存 adj. 常备的，存货的 vt. 提供货物 vi. 出新芽 
stocking	[ˈstɑ:kɪŋ, ˈstɒkɪŋ] n. 长袜 
stomach	[ˈstʌmək] n. 胃;腹部 vt. 容忍;吃…吃得津津有味 
stone	[stoʊn, stəʊn] n. 石头 vt. 向扔石块 adj. 石制的 adv. 石一般的 
stool	[stu:l, stul] n. 凳子，高脚凳;大便，粪便 v. 长出新枝;排便 
stoop	[stu:p, stup] n. 屈服;门廊，游廊 vt.&vi. 弯腰;屈服，忍辱 
stop	[stɑ:p, stɒp] vi. 停止 vt. 塞住 n. 停止 
store	[stɔ:(r), stɔr, stor] n. 商店;贮存物 v. 贮存;（在计算机里）存储 
storey	['stɔ:rɪ, ˈstɔri, ˈstori] n. <英>楼层 
storm	[stɔ:m, stɔ:rm] n. 暴风雨，暴风雪 vi. 起风暴，下暴雨 vt. 袭击，猛攻 
story	[ˈstɔri, ˈstori, ˈstɔ:ri] n. 故事，传说 vt. 用历史故事画装饰 vi. 说谎 
stove	[stoʊv, stəʊv] n. 炉，火炉;窑 v. 用火炉烤 
straight	[streɪt, stret] adj. 直的 adv. 直地 n. 直线 
straightforward	[ˌstreɪtˈfɔ:wəd, ˌstreɪtˈfɔ:rwərd] adj. 直截了当的;坦率的 adv. 直截了当地;坦率地 
strain	[streɪn, stren] vt.&vi. 拉紧，拉伤 n. 血统，家族 vt. 拉紧，拽紧或扯紧 vi. 不懈 
strange	[strendʒ, streɪndʒ] adj. 陌生的，生疏的;奇怪的，古怪的 adv. 奇怪地;陌生地 
stranger	[ˈstrendʒɚ, ˈstreɪndʒə(r)] n. 外地人;陌生人，不认识的人 adj. 不熟悉的，陌生的(strange)的比较级 
strategy	[ˈstrætədʒi] n. 策略，战略 
straw	[strɔ:, strɔ] n. 稻草;吸管 adj. 稻草的，麦秆的;稻草[麦秆]做的 
strawberry	[ˈstrɔ:bəri, ˈstrɔ:beri] n. 草莓 
stream	[stri:m, strim] n. 河流，小河，川，溪 vt.&vi. 流，流动 vi. 飘扬 vt. 按能力分班（或分组） 
street	[stri:t, strit] n. 大街，街道 
strength	[streŋθ, strɛŋkθ, strɛŋθ, strɛnθ] n. 力量 
strengthen	[ˈstreŋθn, ˈstrɛŋkθən,ˈstrɛŋ-,ˈstrɛn-] vt. 加强，巩固;勉励，激励 vi. 变强;变坚挺 
stress	[stres,  strɛs] n. 压力;强调 vt. 重读;[机械学]使承受压力 
stretch	[strɛtʃ, stretʃ] v. 伸展 n. 伸展 adj. 可伸缩的 
strict	[strɪkt] adj. 精确的 
strike	[straɪk] vt. 攻击 vi. 罢工 n. 攻击 
striking	[ˈstraɪkɪŋ] adj. 引人注目的;显著的 v. 击;打( strike的现在分词) 
string	[strɪŋ] n. 串;绳子，带子 vt. 上弦，调弦;使排成一行或一系列 
strip	[strɪp] vi. 剥光 vt. 除去，剥去 n. 长条，条板 
stroke	[strəʊk, stroʊk] n. 中风 vt. 划掉 vi. 击球 
strong	[strɔ:ŋ, strɒŋ] adj. 强烈的;强的 adv. 强劲地;猛烈地 
structure	[ˈstrʌktʃə(r), ˈstrʌktʃɚ] n. 结构;构造 vt. 构成，排列;安排 
struggle	[ˈstrʌgl, ˈstrʌɡəl] vi. 奋斗;搏斗 n. 奋斗;打斗 
stubborn	[ˈstʌbən, ˈstʌbərn] adj. 顽固的，固执的 
student	[ˈstu:dnt, ˈstju:dnt] n. 中学生 
studio	[ˈstju:diəʊ, ˈstu:dioʊ] n. 工作室，画室 
study	[ˈstʌdi] n. 学习，研究 vi. 考虑 vt. 想出 
stuff	[stʌf] n. 材料，原料，资料 vt. 塞满 vi. 吃得过多 
stuffy	[ˈstʌfi] adj. 闷热的，不通气的 
stupid	[ˈstu:pɪd, ˈstju:pɪd] adj. 愚蠢的;迟钝的 n. <口>傻子，笨蛋 
style	[staɪl] n. 方式 vt. 设计 vi. 使符合流行式样 
subject	[ˈsʌbdʒekt, ˈsʌbdʒɪkt] n. 主题，话题 adj. 须服从…的 v. 提供，提出 
submit	[səbˈmɪt] vi. 顺从，服从;甘受，忍受 vt. 使服从，使顺从;提交，呈送 
substance	[ˈsʌbstəns] n. 物质，材料 
substitute	[ˈsʌbstɪtju:t, ˈsʌbstɪtu:t] vt.&vi. 代替，替换，代用 n. 替代物 vi. 用…替代 
subtract	[səbˈtrækt] vt. 减去 
suburb	[ˈsʌbɜ:b, ˈsʌbɜ:rb] n. 郊区，城郊 
succeed	[səkˈsi:d, səkˈsid] vi. 成功;继承 vt. 继承，继任，继位;随…之后 
success	[səkˈses, səkˈsɛs] n. 成功，成就 
successful	[səkˈsɛsfəl, səkˈsesfl] adj. 成功的，如愿以偿的 
successor	[səkˈsesə(r), səkˈsɛsɚ] n. 接替的人或事物 
such	[sʌtʃ] adj. 这样的;如此的 pron. 这样的事物[人] 
sudden	[ˈsʌdn] adj. 突然的，未预见到的 
suddenly	[ˈsʌdənli, ˈsʌdn:lɪ] adv. 意外地，忽然地 
suffer	[ˈsʌfə(r),  ˈsʌfɚ] vi. 受痛苦;受损害 vt. 遭受;忍受 
sufficient	[səˈfɪʃnt, səˈfɪʃənt] adj. 足够的 
sugar	[ˈʃʊgə(r), ˈʃʊɡɚ] n. 食糖 vt. 在…加糖 vi. 形成糖 int. （做了蠢事或出现差错时表示懊恼，用作 shit 的委婉语）哎呀，真是的 
suggest	[səɡˈdʒɛst, səˈdʒɛst, səˈdʒest] vt. 暗示 
suggestion	[səɡˈdʒɛstʃən, səˈdʒɛs-, səˈdʒestʃən] n. 建议，意见，暗示 
suit	[su:t, sut] n. 诉讼 vt. 适合于（某人） vi. 合适，相称 
suitable	[ˈsu:təbl, ˈsutəbəl] adj. 合适的，适当的，适宜的，恰当的 
sum	[sʌm] n. 金额;总数 vt.&vi. 归纳;总计 
summer	[ˈsʌmə(r), ˈsʌmɚ] n. 夏，夏天 adj. 夏季的 v. 度过夏季，避暑 
sun	[sʌn] n. 太阳，阳光;恒星 v. 晒太阳 
Sunday	[ˈsʌnˌdeɪ, ˈsʌndeɪ] n. 星期日，星期天 
sunny	[ˈsʌni] adj. 和煦的：照到阳光的 
sunrise	[ˈsʌnraɪz, ˈsʌnˌraɪz] n. 日出（时分），黎明 
sunset	[ˈsʌnset, ˈsʌnˌsɛt] n. 晚霞;黄昏 adj. 定期废止的 
sunshine	[ˈsʌnʃaɪn, ˈsʌnˌʃaɪn] n. 阳光，日光 
super	[ˈsu:pə(r), ˈsupɚ] adj. 超级的，极度的，过分的，超等的，极好的 n. 特级品，特大号商品 adv. 非常，过分地 v. 用上浆纱布装（书脊） 
superb	[su:ˈpɜ:b, su:ˈpɜ:rb] adj. 极好的 
superior	[su:ˈpɪriə(r), su:ˈpɪəriə(r)] adj. （级别、地位）较高的;（在质量等方面）较好的 n. 上级;较好的人[事物]，优胜者 
superiority	[su:ˌpɪriˈɔ:rəti, su:ˌpɪəriˈɒrəti] n. 优越（性），优等 
supermarket	[ˈsu:pərmɑ:rkət, ˈsu:pəmɑ:kɪt] n. 超级市场 
supper	[ˈsʌpə(r), ˈsʌpɚ] n. 晚饭，晚餐 
supplement	[ˈsʌplɪmənt, ˈsʌpləmənt] vt. 增补，补充 n. 增补，补充;补充物 
supply	[səˈplaɪ] vt. 供给 n. 供给物 vi. 暂代他人职务 
support	[səˈpɔ:t, səˈpɔ:rt] vt. 支持;支撑 n. 支撑;支持者 
suppose	[səˈpəʊz, səˈpoʊz] vt. 认为;假定 vi. 想象，猜想 
suppress	[səˈpres, səˈprɛs] vt. 镇压，压制 
supreme	[su:ˈpri:m, sʊˈprim] adj. 最高的 
sure	[ʃʊə(r), ʃʊr] adj. 确信的，确实的;有把握的 adv. 当然;确实地 
surface	[ˈsɜ:rfɪs, ˈsɜ:fɪs] n. 表面 vi. 浮出水面 vt. 使浮出水面 adj. 表面的，外观的 
surgeon	[ˈsɜ:dʒən, ˈsɜ:rdʒən] n. 外科医生 
surname	[ˈsɜ:rneɪm, ˈsɜ:neɪm] n. 姓，姓氏;别名，绰号 vt. 给…加姓 
surplus	[ˈsɜ:pləs, ˈsɜ:rpləs] adj. 过剩的;多余的 n. 盈余;顺差 
surprise	[səˈpraɪz, sərˈpraɪz] vt. 使惊奇;突袭 n. 惊喜，惊奇;意外的事 
surprising	[səˈpraɪzɪŋ, sərˈpraɪzɪŋ] adj. 使人惊讶的，出人意料的，惊人的;惊人的，意外的 v. 使惊奇，使诧异( surprise的现在分词);意外发现[撞见]，出其不意获得 
surrender	[səˈrɛndɚ, səˈrendə(r)] vi. 投降 vt. 交出 n. 投降 
surround	[səˈraʊnd] vt. 包围，围绕 n. （物品的）边;外围物 
survey	[ˈsɜ:rveɪ, ˈsɜ:veɪ] vi. 测量土地 vt. 调查 n. 调查（表），调查所，测量，测量部，测量图 
survival	[sərˈvaɪvl, səˈvaɪvl] n. 幸存，生存 
survive	[səˈvaɪv, sərˈvaɪv] vi. 幸存，活下来 vt. 幸存 vt.&vi. 幸免于难 
suspect	[səˈspekt, səˈspɛkt] vt. 猜疑（是） n. 嫌疑犯 vi. 怀疑 
suspicious	[səˈspɪʃəs] adj. 可疑的 
swallow	[ˈswɑ:loʊ, ˈswɒləʊ] vt.&vi. 吞，咽 vt. 不流露 n. [鸟]燕子 
sway	[swe, sweɪ] vi. 摇摆 vt. 使前后或来回摇摆 n. 摇摆 
swear	[sweə(r), swer] v. 发誓;咒骂 n. 咒骂;发誓，宣誓 
sweat	[swet, swɛt] vi. 流汗，渗出 vt. 使出汗 n. 汗水 
sweater	[ˈswetə(r), ˈswɛtɚ] n. 毛衣，运动衫;出汗（过多）的人，发汗剂 adj. 运动衫的;运动衫式的 
sweep	[swip, swi:p] vt. 扫除 vi. 打扫 n. 打扫 
sweet	[swit, swi:t] adj. 甜的;愉快的，快乐的 n. 甜味;糖果，甜食 
swell	[swel, swɛl] vt.&vi. 膨胀 n. 汹涌 adj. 极好的 
swift	[swɪft] adj. 迅速的 n. 雨燕 adv. 迅速地，敏捷地 
swim	[swɪm] v. 游泳;游动 n. 游泳 
swing	[swɪŋ] vt.&vi. （使）摇摆 n. 秋千 vt. 使旋转 vi. 悬摆 
Swiss	[swɪs] adj. （人）来自瑞士的;瑞士的，瑞士文化的 n. 瑞士人 
switch	[swɪtʃ] n. 开关 vt.&vi. 转换 vt. 转换 vi. 交换 
sword	[sɔ:d, sɔ:rd] n. 剑，刀 
symbol	[ˈsɪmbl, ˈsɪmbəl] n. 符号;象征 vt. 用符号代表 
sympathetic	[ˌsɪmpəˈθetɪk, ˌsɪmpəˈθɛtɪk] adj. 同情的，有同情心的 
sympathy	[ˈsɪmpəθi] n. 慰问 
system	[ˈsɪstəm] n. 制度 
table	[ˈtebəl, ˈteɪbl] n. 桌子 vt. 制表 adj. 桌子的 
tablet	[ˈtæblɪt, ˈtæblət] n. 药片;碑，匾 vt. 用碑牌纪念;将（备忘录等）写在板上 
tactics	['tæktɪks, ˈtæktɪks] n. 战术 
tail	[teɪl, tel] n. 尾 vt. 跟踪 vi. 队伍单行行进时拉长或产生间隔 
tailor	[ˈteɪlə(r), ˈtelɚ] n. 裁缝，成衣工 vi. 做裁缝 vt. 调整使适应 
take	[teɪk, tek] vt. 采取 vi. 拿 n. 镜头 
tale	[teɪl, tel] n. 传说，传言 
talent	[ˈtælənt] n. 天资，才能 
talk	[tɔ:k, tɔk] v. 说话;讨论 n. 交谈;讨论 
tall	[tɔl, tɔ:l] adj. 身材高的，高大的;（数量）大的 adv. 夸大地;趾高气扬地 
tame	[tem, teɪm] adj. 驯服的;平淡的 v. 驯服;抑制 
tank	[tæŋk] n. 坦克;油[水]箱 vt. 把…贮放在柜内;打败 
tap	[tæp] vt. 开发 vi. 轻声走 n. 龙头，阀门 
tape	[teɪp, tep] n. 带子 vt. 录音 vt.&vi. 录音 
target	[ˈtɑ:rgɪt, ˈtɑ:gɪt] n. 目标;目的 vt. 瞄准;把…作为攻击目标 
tariff	[ˈtærɪf] n. 关税;关税表 vt. 征收关税;定税率 
task	[tɑ:sk, tæsk] n. 作业;工作，任务 vt. 交给某人（任务）;使过于劳累 
taste	[test, teɪst] n. 滋味 vt.&vi. 尝，品尝 vt. 吃 vi. 尝味 
tax	[tæks] vt. 使负重担;消耗精力 n. 税，税额;负担 
taxi	[ˈtæksi] n. 出租车 vi. 乘出租车 vt. 用出租车运送 
tea	[ti:, ti] n. 茶 vt. 给…沏茶 vi. 喝茶 
teach	[titʃ, ti:tʃ] vt. 教;教授 vi. 教书 
teacher	[ˈti:tʃə(r), ˈtitʃɚ] n. 教师，教员，老师，先生 
team	[tim, ti:m] n. 团队;队，组 vi. 协同工作;合作 
tear	[teə(r), ter ] v. 撕裂;拉掉 n. 破洞;裂口 
tease	[tiz, ti:z] vt. 挑逗 vi. 梳理（羊毛等） n. 爱嘲弄他人的人 
technical	[ˈtɛknɪkəl, ˈteknɪkl] adj. 技术（性）的，工艺的，学术（上）的，专门（技术）的，艺术的 
technique	[tɛkˈnik, tekˈni:k] n. 技术 
telegram	[ˈtelɪgræm, ˈtɛlɪˌɡræm] n. 电报 vt. 电报：用电报机发送的信息 
telegraph	[ˈtelɪgrɑ:f, ˈtelɪgræf] n. 电报 vt.&vi. 打电报 vt. 用电报发送 
telephone	[ˈtelɪfəʊn, ˈtelɪfoʊn] n. 电话;电话机 vt.&vi. 以电话传送（消息），给（某人）打电话;用电话与（某人）交谈 
television	[ˈtelɪvɪʒn, ˈtɛləˌvɪʒən] n. 电视节目 
tell	[tɛl, tel] vt. 讲述 vt.&vi. 分辨，辨别 vi. 泄密，告发 n. [考古学]（古代村落遗址堆积而成的）台形土墩 
temper	[ˈtempə(r), ˈtɛmpɚ] n. 性情，脾气 vt. 锻炼 vi. 使调和 
temperature	[ˈtemprətʃə(r), ˈtɛmpərəˌtʃʊr,-tʃɚ,ˈtɛmprə-] n. 温度 
temple	[ˈtempl, ˈtɛmpəl] n. 庙，寺 
temporary	[ˈtemprəri, ˈtempəreri] adj. 短暂的;临时的，暂时的 n. 临时工，临时雇员 
tempt	[tɛmpt, tempt] vt. 吸引;引诱，怂恿 vi. 有吸引力 
ten	[ten, tɛn] num. 十，十个;第十 n. 十个人;十点钟 
tend	[tɛnd, tend] vt. 照料，照顾;护理 vi. 倾向（于），趋向（于）;伺侯，招待 
tendency	[ˈtendənsi, ˈtɛndənsi] n. 倾向，趋势 
tender	[ˈtɛndɚ, ˈtendə(r)] adj. 温柔的 n. 投标 vt. 正式提出 
tennis	['tenɪs, ˈtenɪs] n. 网球（运动） 
tense	[tens, tɛns] adj. 拉紧的 n. [语]时，时态 v. 使或变的紧张 
tent	[tɛnt, tent] n. 帐篷 vi. 住帐蓬 vt. 用帐蓬遮盖 
term	[tɜ:m, tɜ:rm] n. 术语;期限 vt. 把…称为;把…叫做 
terminal	[ˈtɜ:rmɪnl, ˈtɜ:mɪnl] adj. 末端的;末期的 n. 终端;终点站 
terrible	[ˈterəbl, ˈtɛrəbəl] adj. 可怕的 adv. 口〉非常，很，极 n. 可怕的人 
territory	[ˈterətɔ:ri, ˈterətri] n. 领地 
terror	[ˈtɛrɚ, ˈterə(r)] n. 恐怖 
test	[test] n. 试验 vt. 测验 vi. 受试验 
text	[tekst, tɛkst] n. 文本，原文;课文，教科书 v. 发短信 
textbook	[ˈtekstbʊk, ˈtɛkstˌbʊk] n. 教材;教科书 adj. 规范的;标准的 
than	[ðən] conj. 比（用于比较级）;宁愿…而不愿 prep. 比;超过 
thank	[θæŋk] vt. 谢谢，感谢;责怪，把…归于 n. 感谢，谢谢，道谢的话 
Thanksgiving	[ˌθæŋks'ɡɪvɪŋ, θæŋksˈɡɪvɪŋ] n. 感恩节 
that	[ðæt, ðæt, ðət] det. 那个，那 pron. 那个，那 conj. 多么 adv. 不那么 
the	[ðə] art. 指已提到的人（物） 
theater	['θɪətə, ˈθi:ətər] n. 剧场 
theft	[θɛft, θeft] n. 偷盗，偷窃 
their	[ðer, ðeə(r)] pron. 他（她，它）们的 
theirs	[ðeəz, ðerz] pron. 他们的 
them	[ðəm] pron. 他们 
theme	[θi:m, θim] n. [乐]主题;主旋律 adj. 以奇想主题布置的 
themselves	[ðəmˈselvz, ðɛmˈsɛlvz, ðəm-] pron. 他[她，它]们自己 
then	[ðɛn, ðen] adv. 然后;那么 adj. 当时的;那时的 
theory	[ˈθɪəri, ˈθɪri] n. 理论 
there	[ðer, ðeə(r)] adv. 那里 pron. 表示某物或某人的存在或某事的发生（常用作be
therefore	[ˈðeəfɔ:(r), ˈðerfɔ:(r)] adv. 因此 
these	[ðiz, ði:z] adj. 这些的 pron. 这些 
they	[ðe, ðeɪ] pron. 她们 
thick	[θɪk] adj. 浓的，茂密的 adv. 密集地 n. 最厚的部分 
thief	[θi:f, θif] n. 小偷，盗贼 
thin	[θɪn] adj. 薄的 vt. 使瘦 vi. 变薄 adv. 稀疏地，微弱地 
thing	[θɪŋ] n. 事件，形势 
think	[θɪŋk] vt. 想 vi. 考虑 adj. 深思的 n. 想 
thinking	[ˈθɪŋkɪŋ] n. 思考 adj. 有思想的 v. “think”的现在分词 
third	[θɜ:rd, θɜ:d] n. 第三;三分之一 adj. 第三的;三分之一的 
thirdly	[ˈθɜ:dli, ˈθɜ:rdli] adv. 第三 
thirst	[θɜ:rst, θɜ:st] n. （口）渴;渴感 vi. 口渴;渴望 
thirsty	[ˈθɜ:sti, ˈθɜ:rsti] adj. 口渴的 
thirteen	[ˌθɜ:rˈti:n, ˌθɜ:ˈti:n] n. 十三 num. 十三 adj. 十三的，十三个的 
thirty	[ˈθɜ:rti, ˈθɜ:ti] n. 三十 adj. 三十的，三十个的 num. 三十 
this	[ðɪs] pron. 这，这个 adj. 这，这个 adv. 这样地 
thorough	[ˈθʌrə, ˈθɜ:roʊ] adj. 彻底的，全面的，充分的，彻头彻尾的，根本的，详尽的，严密的 prep. 〈古〉同“through” n. [英史]专横政策 
those	[ðoʊz, ðəʊz] adj.&pron. that的复数 adj. 那些的，那 n. 那，那个( that的名词复数) 
though	[ðoʊ, ðəʊ] conj. 即使 adv. 不过 prep. 但 
thought	[θɔt, θɔ:t] n. 思想;想法 v. 认为;以为 
thoughtful	[ˈθɔ:tfl, ˈθɔtfəl] adj. 体贴的 
thousand	[ˈθaʊznd, ˈθaʊzənd] n. 一千;数千 adj. 一千的;一千个的 
thread	[θrɛd, θred] n. 螺纹;线 vt. 穿成串;将（针、线等）穿过… 
threat	[θrɛt, θret] n. 威胁 
threaten	[ˈθrɛtn, ˈθretn] vt.&vi. 危及;恐吓 vi. 威胁;似将发生 
three	[θri:, θri] num. 三 n. 三岁 adj. 三的 
thrill	[θrɪl] vt. 使激动 vi. 由于兴奋或激动而感到一种突然的颤动 n. [病]震颤 
throat	[θrəʊt, θroʊt] n. 咽喉;颈前部 vt. 用沙哑的声音或嗓音发音 
throne	[θroʊn, θrəʊn] n. 宝座 vi. 登上王座 vt. 使即王位，使登基 
through	[θru:, θru] prep. 透过 adv. 从头到尾 adj. （电话）接通 
throughout	[θru:ˈaʊt,  θruˈaʊt] prep. （表示时间）自始至终;在…期间 adv. 始终;处处 
throw	[θrəʊ, θroʊ] vi. 丢 n. 丢 vt. 抛 
thrust	[θrʌst] vt.&vi. 猛推 n. 推力 vi. 插入 
thumb	[θʌm] n. 拇指 vi. 翘起拇指请求搭乘（过路汽车），示意请求搭便车 vt. 翻阅 
thunder	[ˈθʌndə(r), ˈθʌndɚ] n. 雷声 vi. 打雷 vt.&vi. 发出隆隆声 
Thursday	[ˈθɜ:rzdeɪ, ˈθɜ:zdeɪ] n. 星期四，礼拜四，周四 
thus	[ðʌs] adv. 于是，因此;如此，这样，像这样，例如 conj. 因此 
tick	[tɪk] n. 壁虱;钩号 v. 发出滴答声;在（纸）上打钩 
ticket	[ˈtɪkɪt] n. 票，入场券;标签 vt. 售票;给…门票 
tide	[taɪd] n. 潮汐;潮流，趋势 vt. 顺应潮水航行;使随潮水漂行 
tidy	[ˈtaɪdi] adj. 整洁的，整齐的 n. 盛零碎物品的容器 vt.&vi. 使整洁 
tie	[taɪ] n. 关系 vt. （用线、绳等）系 vi. 打结，系上 
tiger	[ˈtaɪɡɚ, ˈtaɪgə(r)] n. 老虎 
tight	[taɪt] adj. 紧的，牢固的;绷紧的 adv. 紧紧地;牢固地 
tile	[taɪl] n. 瓦片，瓷砖;空心砖 vt. 用瓦片、瓷砖等覆盖 
till	[tɪl] conj. 直到…时（为止） vt. 耕种 n. 钱柜，钱箱 prep. 直到 
timber	[ˈtɪmbɚ, ˈtɪmbə(r)] n. 木材，木料;（用于建筑或制作物品的）树木 vt. 用木料支撑;备以木材 
time	[taɪm] n. 时间 vt. 为…安排时间 vi. 合拍 adj. 定时的 int. [体育]时间到，（一场或一局等的）比赛时限，暂停 
time-saving	[taɪm ˈsevɪŋ, taim ˈseiviŋ] adj. 节省时间的 
timetable	[ˈtaɪmteɪbl, ˈtaɪmˌtebəl] n. 计划;交通工具的运行时间表，时刻表 vi. 为…安排时间 
tin	[tɪn] n. 锡 adj. 锡制的 vt. 镀锡，包锡 
tiny	[ˈtaɪni] adj. 极小的，微小的 n. 小孩子;[医]癣 
tip	[tɪp] n. 小费 vt. 给小费 vi. 给小费 
tire	[ˈtaɪə(r), taɪr] vt. 使…疲惫 vi. 疲劳 n. 轮胎 
tired	[ˈtaɪərd, ˈtaɪəd] adj. 疲倦的;困倦的 v. （使）疲劳（ tire的过去式和过去分词）;对（做）某事感到厌倦 
title	[ˈtaɪtl] n. 标题 vt. 加标题 adj. 标题的 
to	[tu,tə, tə] prep. 到;向，朝着 adv. 朝一个方向的;到某种状态 
toast	[toʊst, təʊst] n. 烤面包 vt.&vi. 向…祝酒，为…干杯 vi. 烤火，取暖 
tobacco	[təˈbækoʊ, təˈbækəʊ] n. 卷烟 
today	[təˈdeɪ, təˈde] adv. 现在;现今 n. 现今;今天，今日 
toe	[təʊ, toʊ] n. 脚趾，脚尖 vt. 用脚尖触 vi. 动脚尖 
together	[təˈɡɛðɚ, təˈgeðə(r)] adv. 在一起;同时 adj. 稳定可靠的;做事有效率的 
toilet	[ˈtɔɪlət, 'tɔɪlət] n. 洗手间 
tolerate	[ˈtɒləreɪt, ˈtɑ:ləreɪt] vt. 忍受 
tomato	[təˈmɑ:təʊ, təˈmeɪtoʊ] n. 番茄，西红柿 
tomb	[tum, tu:m] n. 坟墓;墓穴 v. 埋葬 
tomorrow	[təˈmɒrəʊ, təˈmɑ:roʊ] adv. 在明天，在明日 n. 明天;最近，不远的将来 
ton	[tʌn] n. 吨 
tone	[təʊn, toʊn] n. [语]声调，语调 vt. 使更健壮 vi. 带有某种腔调 
tongue	[tʌŋ] n. 舌头，喙 vt. 用舌吹 vi. 吹奏（管乐器） 
tonight	[təˈnaɪt] n. 今晚，今夜 adv. 在今晚 
too	[tu:] adv. 太 
tool	[tu:l, tul] n. 器具，工具 vt. 用工具给…加工 vi. 使用工具 
tooth	[tu:θ, tuθ] n. 齿 vt. 给…装齿 vi. 啮合 
top	[tɑ:p, tɒp] n. 顶，顶部 adj. 最高的 vt. 形成顶部 vi. 总结 
topic	[ˈtɒpɪk, ˈtɑ:pɪk] n. 主题 
torch	[tɔ:tʃ, tɔ:rtʃ] n. 手电筒;火把，火炬 vt.&vi. 放火烧，纵火烧（建筑物或汽车） 
toss	[tɒs, tɔ:s] vt.&vi. （轻轻或漫不经心地）扔;（使）摇荡 n. 掷硬币决定;向上甩头 
total	[ˈtəʊtl, ˈtoʊtl] adj. 总计的（金额等） n. 总计，总数 vt.&vi. 总计达，计算…的总数 
touch	[tʌtʃ] vt. 触摸 n. 触摸，碰 vi. 联系 
tough	[tʌf] adj. 坚强的，坚韧的，不屈不挠的 n. 粗暴的人 vt. <口>忍耐，忍受（常与out连用） adv. 强硬地，顽强地 
tour	[tʊr, tʊə(r)] n. 巡回演出 vt. 到…旅游 vi. 巡回 
tourist	[ˈtʊrɪst, ˈtʊərɪst] n. 旅行者，观光客 
tow	[təʊ, toʊ] vt. 牵引;拖，拉 n. 拖曳的行为或情况;被拖曳的某物 
towards	[təˈwɔ:dz, tɔ:rdz] prep. 对于 
towel	[ˈtaʊəl] n. 纸巾 vt. 用毛巾擦 vi. 用毛巾擦干身体 
tower	[ˈtaʊə(r), ˈtaʊɚ] n. 塔，楼塔 vi. 远远高于，远远超过 na. “Towers“的变体 
town	[taʊn] n. 城镇，市镇 
toy	[tɔɪ] n. 玩具，玩物 vi. 玩弄 adj. 玩具的 
trace	[treɪs, tres] vt. 跟踪，追踪 vi. 沿着一小径或道路前进 n. 痕迹 
track	[træk] n. 小路，小道 vt. 跟踪 vi. 沿着轨道前进 
tractor	[ˈtræktə(r), ˈtræktɚ] n. 拖拉机 
trade	[treɪd, treid] n. 贸易 vt.&vi. 交易，经商 vt. 交换 vi. 贸易 
trademark	[ˈtreɪdmɑ:k, ˈtreɪdmɑ:rk] n. （注册）商标 
tradition	[trəˈdɪʃn, trəˈdɪʃən] n. 传统 
traffic	[ˈtræfɪk] n. 交通，运输量 vt. 用…作交换 vi. 交易 
tragedy	[ˈtrædʒɪdi, ˈtrædʒədi] n. 悲剧，惨剧 
trail	[treɪl, trel] vt. 跟踪，追踪 vi. （在比赛等中）输 n. 小径 
train	[tren, treɪn] n. 火车;行列 v. 训练;培养 
training	[ˈtrenɪŋ, ˈtreɪnɪŋ] n. 训练;培养 v. 训练，培养( train的现在分词);教育 
traitor	[ˈtreɪtə(r), ˈtretɚ] n. 叛徒 
transfer	[trænsˈfɜ:(r), trænsˈfɚ] vt. 使转移 vi. 转让 n. 转移 
translate	[trænsˈleɪt, trænsˈlet, trænz-, ˈtrænsˌlet, ˈtrænz-] vt.&vi. 翻译 
translation	[trænsˈleʃən, trænz-, trænsˈleɪʃn] n. 翻译 
transport	[ˈtrænspɔ:t, ˈtrænspɔ:rt] vt. 运送，运输;流放 n. 运输;运输船（机），运输系统 
trap	[træp] vt. 诱骗 n. 圈套 vi. 设陷阱 
travel	[ˈtrævl, ˈtrævəl] n. 旅行 vi. 旅行 vt. 经过，通过 
traveller	[ˈtræv(ə)lər, 'trævələ(r)] n. 旅行者，旅客 
treasure	[ˈtreʒə(r), ˈtrɛʒɚ] n. 宝藏;珍宝 vt. 珍惜;重视 
treat	[tri:t, trit] n. 招待;款待 v. 治疗;对待 
treatment	[ˈtri:tmənt, ˈtritmənt] n. 处理 
treaty	[ˈtri:ti, ˈtriti] n. 条约 
tree	[tri:, tri] n. 树;木料 vt. 把…赶上树;使处于困境 
tremble	[ˈtrembl, ˈtrɛmbəl] vi. 发抖 n. 战栗 vt. 使挥动 
tremendous	[trəˈmendəs, trɪˈmɛndəs] adj. 极大的，巨大的 
trend	[trɛnd, trend] n. 趋向;走向 vi. 趋势;倾向 
trial	[ˈtraɪəl, ˈtraɪəl, traɪl] n. 试验;[法]审讯，审判 adj. 试验的;[法]审讯的 
triangle	[ˈtraɪæŋgl, ˈtraɪˌæŋɡəl] n. 三角形 
tribe	[traɪb] n. 部落，部族 
trick	[trɪk] n. 恶作剧 vt. 哄骗，欺骗 adj. 弄虚作假的 
trim	[trɪm] vt. 装饰 adj. 整齐的，整洁的 n. 修剪 vi. 削减 
trip	[trɪp] n. 旅游，出行 vi. 旅行 vt. 使犯错误 
triumph	[ˈtraɪʌmf, ˈtraɪəmf] n. 胜利;巨大的成就 vi. 战胜;获胜 
troop	[tru:p, trup] n. 军队 vi. 成群结队地走 vt. 把（骑兵）编成骑兵连 
tropical	[ˈtrɑ:pɪkl, ˈtrɒpɪkl] adj. 热带的 
trouble	[ˈtrʌbəl, ˈtrʌbl] n. 麻烦 vi. 烦恼 vt. 麻烦 
trousers	[ˈtraʊzəz, ˈtraʊzərz] n. 裤子 
truck	[trʌk] n. 货车 vt. 用卡车装运 vi. 驾驶卡车 
trunk	[trʌŋk] n. 树干 
trust	[trʌst] n. 信任 vt.&vi. 相信， 信任 vt. 相信 
truth	[tru:θ, truθ] n. 真理 
try	[traɪ] vt.&vi. 试图，努力;实验 n. 尝试，实验;[橄]触球，（因触球获得的）向球门踢球的权利 
tub	[tʌb] n. 桶 vt. 把…装入桶 vi. 洗盆浴 
tube	[tju:b, tu:b] n. 管，管状物 vt. 把…装管 vi. 乘地铁 
Tuesday	[ˈtju:zdeɪ, ˈtu:zdeɪ] n. 星期二 
tumble	[ˈtʌmbl, ˈtʌmbəl] vi. 跌倒，摔倒 vt. 使跌倒 n. 摔倒 
tune	[tju:n, tu:n] n. 曲调，曲子 vt. 调整 vi. 协调 
tunnel	[ˈtʌnl, ˈtʌnəl] n. 隧道 vi. 打通隧道 vt. 在…挖掘隧道 
ture	[]  油温测量装置；介观结构 
turkey	[ˈtɜ:ki, ˈtɜ:rki] n. 火鸡 
turn	[tɜ:rn, tɜ:n] vt.&vi. 使转动 vt. 使变酸 n. 翻转 
twelfth	[twɛlfθ, twelfθ] n. 第十二;十二分之一 adj. 第十二的;第十二个的 
twelve	[twelv, twɛlv] num. 十二 adj. 十二的 n. 十二；十二个 
twentieth	['twentɪəθ, ˈtwɛntiɪθ, ˈtwʌn-] n. 二十分之一 adj. 第二十的 num. 第二十 
twenty	[ˈtwenti, ˈtwɛnti, ˈtwʌn-] n. 二十，二十个 num. 二十 adj. 二十的 
twice	[twaɪs] adv. 两次 
twin	[twɪn] n. 孪晶 vt. 尤用于英国)使结成姊妹城市 adj. 成对的 
twinkle	[ˈtwɪŋkl, ˈtwɪŋkəl] vi. 闪烁 vt. 闪闪发出 n. 闪光 
twist	[twɪst] vt. 扭成一束 vi. 被搓揉 n. 揉搓之物 
two	[tu:, tu] n. 两个 adj. 两个的 num. 两个 
type	[taɪp] n. 类型 vt.&vi. 打字 vt. [医学]测定（血型） 
typewriter	[ˈtaɪpraɪtə(r), ˈtaɪpˌraɪtɚ] n. 打字机 
typical	[ˈtɪpɪkəl, ˈtɪpɪkl] adj. 典型的 
ugly	[ˈʌɡli, ˈʌgli] adj. 丑陋的;难看的 n. 丑陋的人（东西） 
ultimate	[ˈʌltɪmət, ˈʌltəmɪt] adj. 极限的;最后的 n. 终极;顶点 
umbrella	[ʌmˈbrɛlə, ʌmˈbrelə] n. 雨伞 
unable	[ʌnˈeɪbl, ʌnˈebəl] adj. 不能的，不会的 
unanimous	[jʊˈnænəməs, juˈnænɪməs] adj. 全体一致的 
uncertain	[ʌnˈsɜ:rtn, ʌnˈsɜ:tn] adj. 不确定的 
uncle	[ˈʌŋkəl, ˈʌŋkl] n. 叔叔 
under	[ˈʌndə(r), ˈʌndɚ] prep. 在…下面，在表面之下 adv. 在下面 adj. 较低的，下面的 
undergo	[ˌʌndəˈgəʊ, ˌʌndərˈgoʊ] vt. 经历，经验 
underground	[ˈʌndərgraʊnd, ˈʌndəgraʊnd] adj. 地下的 
underneath	[ˌʌndərˈni:θ, ˌʌndəˈni:θ] adj. 下面的 adv. 在下面，在底下 prep. 在下面 n. 下部，底部 
understand	[ˌʌndərˈstænd, ˌʌndəˈstænd] vt.&vi. 懂，理解 vt. 了解;领会 
understanding	[ˌʌndərˈstændɪŋ, ˌʌndəˈstændɪŋ] vt. 谅解 vi. 理解，懂得 n. 谅解 adj. 能谅解的 
undo	[ʌnˈdu:, ʌnˈdu] vt. 松开，解开;取消，废除 vi. 撤销 
uniform	[ˈju:nɪfɔ:m, ˈju:nɪfɔ:rm] n. 制服 adj. （形状，性质等）一样的 v. 使规格一律 
union	[ˈju:niən, ˈjunjən] n. 同盟，联盟;协会，工会 adj. 工会的 
unit	[ˈju:nɪt, ˈjunɪt] n. 装置 
unite	[juˈnaɪt] vt. （使）联合，合并，统一;并有，兼备 vi. （为某事）联合，联手，团结 
united	[juˈnaɪtɪd] adj. 联合的;统一的 v. 团结;“unite”的过去式和过去分词 
unity	[ˈjunɪti, ˈju:nəti] n. 团结一致 
universal	[ˌju:nɪˈvɜ:rsl, ˌju:nɪˈvɜ:sl] adj. 普遍的，一般的;通用的，万能的 n. [逻辑学]全称命题;[哲学]一般概念 
universe	[ˈju:nɪvɜ:s, ˈju:nɪvɜ:rs] n. 宇宙 
university	[ˌju:nɪˈvɜ:rsəti, ˌju:nɪˈvɜ:səti] n. 综合性大学 
unknown	[ˌʌnˈnəʊn, ˌʌnˈnoʊn] adj. 未知的;不出名的 n. 未知数;不知名或不出名的人 
unless	[ənˈles, ʌnˈlɛs] conj. 除非，如果不 prep. 除了，…除外 
until	[ənˈtɪl, ʌnˈtɪl] prep. 到…为止;在…以前 conj. 到…为止，在…以前;直到…才 
unusual	[ʌnˈju:ʒuəl, ʌnˈjuʒuəl] adj. 与众不同的 
up	[ʌp] adv. 在上面，在高处 adj. 向上的 vt.&vi. 增加 prep. 在…的上端 n. 上升，升高 
upon	[əˈpɑ:n, əˈpɒn] prep. 在…上面 
upper	[ˈʌpə(r), ˈʌpɚ] adj. 上面的;地位较高的 n. 鞋帮，靴面;兴奋剂 
upset	[ʌpˈset, ʌpˈsɛt] vi. 打翻，弄翻 vt. 打乱，搅乱 n. 心烦意乱 adj. 沮丧的 
upstairs	[ˌʌpˈsteəz, ˌʌpˈsterz] adv. 在楼上，往楼上 adj. 楼上的 n. 楼上 
urban	[ˈɜ:rbən, ˈɜ:bən] adj. 都市的 
urge	[ɜ:rdʒ, ɜ:dʒ] vt. 催促 n. 刺激，冲动 vi. 催促 
urgent	[ˈɜ:rdʒənt, ˈɜ:dʒənt] adj. 急迫的 
us	[əs, ʌs] pron. 我们 
use	[ju:s] n. 使用 
used	[ju:st] adj. 用过的;习惯于 v. 使用（ use的过去式和过去分词）;常常，经常 
useful	[ˈjusfəl, ˈju:sfl] adj. 有用的，有益的，有帮助的 
usual	[ˈjuʒuəl, ˈju:ʒuəl] adj. 通常的，常有的，常见的 
usually	[ˈjuːʒuəli, ˈju:ʒuəli] adv. 通常，经常，平常，惯常地 
utility	[ju:ˈtɪləti, juˈtɪləti] n. 公用事业;功用，效用 adj. 有多种用途的;各种工作都会做的 
utter	[ˈʌtə(r), ˈʌtɚ] vt. 发出声音;说，讲 adj. 彻底的，完全的，绝对的 
vacant	[ˈveɪkənt, ˈvekənt] adj. 空缺的 
vacation	[veˈkeʃən, və-, vəˈkeɪʃn] n. 假期，休假;[古] 空出，撤出，辞去 vi. 度假 
vain	[veɪn, ven] adj. 徒劳的 
valid	[ˈvælɪd] adj. 有效的 
valley	[ˈvæli] n. 流域 
valuable	[ˈvæljuəbl, ˈvæljuəbəl, ˈvæljə-] adj. 有价值的;贵重的，宝贵的 n. 贵重物品，财宝 
value	[ˈvælju, ˈvælju:] n. 价值，价格;意义，涵义 vt. 评价;重视，看重 
vanish	[ˈvænɪʃ] vi. 消失 vt. 使消失，使不见 n. [语音学]消失音，弱化音 
vanity	[ˈvænəti, ˈvænɪti] n. 自负 
variety	[vəˈraɪɪti, vəˈraɪəti] n. 多样 
various	[ˈveriəs, ˈveəriəs] adj. 各种各样的 
vary	[ˈveəri, ˈveri] vi. 变化;不同，偏离 vt. 使不同;使多样化 
vase	[vɑ:z, veɪs] n. 装饰瓶，花瓶 
vast	[væst, vɑ:st] adj. 广阔的;巨大的 n. 浩瀚;广大无边的空间 
vegetable	[ˈvɛdʒtəbəl, ˈvɛdʒɪtə-, ˈvedʒtəbl] n. 蔬菜;植物人 adj. 蔬菜的;植物的 
vehicle	[ˈvi:əkl, ˈvi:hɪkl] n. 车辆 
veil	[vel, veɪl] n. 面纱;掩饰 vt. 用面纱遮盖;掩饰 
velocity	[vəˈlɒsəti, vəˈlɑ:səti] n. 速率，速度 
venture	[ˈvɛntʃɚ, ˈventʃə(r)] n. 冒险 vt. 冒…的危险 vi. 冒险前进，冒险行事 
verb	[vɜ:b, vɜ:rb] n. 动词 
verbal	[ˈvɜ:rbl, ˈvɜ:bl] adj. 口头的 
verge	[vɜ:dʒ, vɜ:rdʒ] n. 边，边缘;界限 vi. 接近，逼近;处于边沿或边缘 
very	[ˈveri, ˈvɛri] adj. 很，非常;恰好是，正是 adv. 很，非常;充分，完全 
vessel	[ˈvesl, ˈvɛsəl] n. 容器 
veto	[ˈvi:toʊ, ˈvi:təʊ] n. 行使否决权 vt. 否决，不同意 vi. 否决 
via	[ˈvaɪə, ˈvaɪə, ˈviə] prep. 经过 
vice	[vaɪs] n. 恶习 prep. 代替 adj. 副的 vt. 用老虎钳夹紧 
victim	[ˈvɪktɪm] n. 牺牲者，受害者 
victory	[ˈvɪktəri] n. 胜利 
video	[ˈvɪdioʊ, ˈvɪdiəʊ] n. 磁带录像 adj. 视频的 vt. 录像 
view	[vju, vju:] n. 看法;风景 vt. 看;看待 
village	[ˈvɪlɪdʒ] n. 村民 
vinegar	[ˈvɪnɪgə(r), ˈvɪnɪɡɚ] n. 醋 
violence	[ˈvaɪələns] n. 暴力，强暴，暴虐 
violent	[ˈvaɪələnt] adj. 暴力引起的 
violet	[ˈvaɪələt, ˈvaɪəlɪt] n. 紫罗兰;蓝紫色，紫罗兰色 adj. 紫罗兰色的;蓝紫色的 
violin	[ˌvaɪəˈlɪn] n. 小提琴 
virus	[ˈvaɪrəs] n. 病毒 
visible	[ˈvɪzəbl, ˈvɪzəbəl] adj. 看得见的 
vision	[ˈvɪʒn, ˈvɪʒən] n. 视力，视觉;美景，绝妙的东西 vt. 在幻觉中看到;幻想，想象 
visit	[ˈvɪzɪt] vt.&vi. 访问 vi. 作客 n. 访问，参观 vt. 拜访，参观 
visitor	[ˈvɪzɪtə(r), ˈvɪzɪtɚ] n. 游客 
vital	[ˈvaɪtl, 'vaɪtl] adj. 至关重要的 
vocabulary	[vəˈkæbjəleri, vəˈkæbjələri] n. （某一语言的）词汇 
vocation	[voʊˈkeɪʃn, vəʊˈkeɪʃn] n. 职业，使命 
volleyball	[ˈvɒlibɔ:l, ˈvɑ:libɔ:l] n. 排球（运动） 
volume	[ˈvɒlju:m, ˈvɑ:lju:m] n. 体积 adj. 大量的 vi. 成团卷起 vt. 把…收集成卷 
volunteer	[ˌvɒlənˈtɪə(r), ˌvɑ:lənˈtɪr] n. 志愿者，志愿兵 adj. 自愿的，志愿的 vt.&vi. 自愿去做 vi. 志愿，义务服务 vt. 志愿提供 
vote	[voʊt, vəʊt] v. 投票表决;投票，选举 n. 投票权;投票，表决 
voyage	[ˈvɔɪɪdʒ] n. 旅程 vi. 航行，旅行 vt. 驶过，横越 
wage	[weɪdʒ, wedʒ] n. 工资;报应 vt.&vi. 实行，进行，作（战等）;〈方〉雇佣 
wagon	[ˈwægən, ˈwæɡən] n. 四轮的运货马车 vt. 用运货马车运输货物 na. “waggon”的变体 
waist	[west, weɪst] n. 腰，腰部 
wait	[weɪt, wet] vt.&vi. 等待 vi. 准备妥 vt. 推迟，搁置，延缓 
waiter	[ˈwetɚ, ˈweɪtə(r)] n. 服务员 
waitress	[ˈwetrɪs, ˈweɪtrəs] n. 女服务员;女侍者 vi. 做女服务员 
wake	[weɪk, wek] vi. 醒，醒来 vt. 激发，唤醒 n. 守灵，守夜 
waken	[ˈwekən, ˈweɪkən] vi. 醒来 vt. 唤醒，弄醒 vt.&vi. 激发 v. 振起，鼓励 
walk	[wɔ:k, wɔk] vt.&vi. 走 n. 步行 vi. 行走 vt. 牵着（动物）走，遛，赶着…走 
wall	[wɔ:l, wɔl] n. 墙 vt.&vi. 筑墙围住，用墙隔开 adj. 墙壁的 
wallet	[ˈwɒlɪt, ˈwɑ:lɪt] n. 钱包，皮夹子 
wander	[ˈwɑ:ndə(r), ˈwɒndə(r)] vt. 漫步，漫游 vi. 游荡，漫游，闲逛，慢走，漫步 n. 游荡 
want	[wɑ:nt, wɒnt] v. 想要;希望 n. 需要的东西;缺少 
war	[wɔ:(r), wɔr] n. 战争;战争期间 vi. 进行战斗，作战;同…处于交战状态 
warm	[wɔ:rm, wɔ:m] adj. 热情的 vt.&vi. （使）变暖，被加热，暖和起来 vt. 加热 n. 暖和的地方 vi. 加温 
warn	[wɔ:rn, wɔ:n] vt. 警告，告诫;通知 vi. 发出警告 
wash	[wɑ:ʃ, wɒʃ] vt. 洗，清洗 vi. 耐洗 n. （尤指船过后划出的）水流 vt. 弄湿 adj. 可洗的，耐洗的 
waste	[west, weɪst] n. 浪费，白费，挥霍钱财 vt.&vi. 浪费 vt. 破坏 adj. 废弃的， 无用的， 荒芜的 
watch	[wɒtʃ, wɑ:tʃ] vt. 注视，注意 n. 表 vi. 观看 
water	[ˈwɔtɚ, ˈwɑtɚ, ˈwɔ:tə(r)] n. 水;海水 v. 给…浇水;供以水 
wave	[weɪv, wev] n. 挥手 vi. 摇摆，起伏 vt.&vi. （一端固定地）飘扬 vt. 挥手表示 
wax	[wæks] n. 蜡，蜡状物 vt. 给…打蜡，给…上蜡 vi. 给…上蜡，给…涂蜡 adj. 蜡制的，似蜡的 
way	[weɪ, we] n. 道路;方法 adv. 远远地，大大地 
we	[wi] pron. 我们，咱们 
weak	[wi:k, wik] adj. 柔弱的，虚弱的 
weakness	[ˈwiknɪs, ˈwi:knəs] n. 弱点，缺点 
wealth	[welθ, wɛlθ] n. 财产，财富 
weapon	[ˈwepən, ˈwɛpən] n. 武器，兵器 vi. 武装，提供武器 
wear	[weə(r), wer] vt. 磨损 vi. 耐用 n. 穿着 
weary	[ˈwɪəri, ˈwɪri] adj. 疲倦的 vt.&vi. （使）疲乏，（使）厌烦 v. 疲倦，疲乏 
weather	[ˈwɛðɚ, ˈweðə(r)] n. 天气， 气象 vt.&vi. 晒干， 风化 vt. 平安渡过， 挨过 
weave	[wi:v, wiv] vt.&vi. 编，织 vt. 编排 vi. 纺织，织布 n. 织物 
wedding	[ˈwedɪŋ, ˈwɛdɪŋ] n. 婚礼 vt. 与…结婚 vi. 婚礼 
Wednesday	[ˈwɛnzdi, -ˌde, ˈwenzdeɪ] n. 星期三 
weed	[wi:d, wid] n. 杂草 vt. 给…除杂草 vi. 除草 
week	[wi:k, wik] n. 一星期，周 
weekday	[ˈwi:kdeɪ, ˈwikˌde] n. 工作日 
weekend	[ˌwi:kˈend, ˈwi:kend] n. 周末 vi. 过周末，度周末 adj. 周末的 
weekly	[ˈwi:kli, ˈwikli] adj. 周刊的 n. 周刊，周报 adv. 一星期一次，每周 
weigh	[weɪ] vt. 称…的重量 vi. 具有重要性 n. 权衡 
weight	[weɪt, wet] n. 重量，体重;重担，重任 vt. 加重于，使变重;使负重，使负担或压迫 
welcome	[ˈwelkəm, ˈwɛlkəm] vt. 欢迎 adj. 受欢迎的 n. 欢迎，迎接 
welfare	[ˈwelfeə(r), ˈwelfer] n. 福利 
well	[wɛl, wel] adv. 好 adj. 良好的 int. （用于表示惊讶，疑虑，接受等） n. 泉 vi. （液体）涌出 vt. 涌出，喷出 
well-known	['wel'nəʊn, ˈwɛlˈnon] adj. 出名的，众所周知的，熟悉的 
west	[west, wɛst] n. 西，西部，西方 adj. 西部的 adv. 向西，朝西 
western	[ˈwestən, ˈwestərn] adj. 西方的;欧美的 n. 西方人;西部电影，西部小说 
westward	['westwəd, ˈwɛstwəd] adj. 向西的 n. 西部，西方 adv. 向西方 
wet	[wɛt, wet] adj. 湿的 n. 湿地 vt. 使潮湿 
what	[wɑ:t, wɒt] pron. （用以询问某人或某事物的词）什么，多少 adj. …的（事物或人） adv. （用于感叹句中） int. （用以表示不相信或惊奇） 
whatever	[wɒtˈevə(r), wətˈevə(r)] pron. 无论什么;任何（事物） adj. 无论什么…都;无论怎样…都 
wheat	[hwit, wit, wi:t] n. 小麦 
wheel	[wi:l] n. 轮子 vi. 转动，旋转 vt. 推 
when	[wɛn, wen] adv. 当时 conj. 如果 pron. 什么时候 n. 时间，时候 
whenever	[wenˈevə(r), hwɛnˈɛvɚ] adv. 究竟什么时候;不论何时 conj. 每当;无论何时 
where	[weə(r), wer] adv. 哪里，在哪里 conj. 在…的地方 n. 地方，场所 pron. 哪里 
whereas	[ˌwerˈæz, ˌweərˈæz] conj. 然而;鉴于 n. “鉴于…”：正式文件的介绍性陈述，开场白;条件性陈述 
wherever	[weərˈevə(r), werˈevə(r)] adv. （究竟）在哪儿 conj. 无论什么地方;各处，处处 
whether	[ˈhwɛðɚ, ˈwɛð-, ˈweðə(r)] pron. 其中的哪一个 n. 可能的选择 
which	[wɪtʃ, hwɪtʃ,wɪtʃ] pron. 哪个;哪一个 adj. 哪一个;哪一些 
while	[hwaɪl, waɪl, waɪl] conj. 而 n. （一段）时间 vt. 消磨，打发（时间） 
whip	[wɪp, hwɪp, wɪp] vt. 鞭打，抽打 vi. 烤，烘 n. 鞭子 
whirl	[wɜ:l, wɜ:rl] vi. 旋转，回旋 vt. 使旋转，使回旋 n. 旋转，回旋 
whisper	[ˈhwɪspɚ,ˈwɪs-, ˈwɪspə(r)] vt. 私语 vi. 耳语 n. 低语，耳语 
whistle	[ˈwɪsl] vi. 吹口哨，吹哨子，鸣汽笛 vt. 由吹口哨而发出 n. 汽笛 
white	[waɪt, hwaɪt, waɪt] adj. 白色的，纯洁的 n. 白色 vt. （书写，印刷等）留出空白处 
who	[hu:, hu] pron. 谁 
whole	[hoʊl, həʊl] adj. 完整的;全部的，所有的 n. 全部;整体，整个 
whom	[hu:m, hum] pron. (who的宾格)谁 
whose	[hu:z, huz] pron. 谁的 
why	[hwaɪ, waɪ, waɪ] adv. 为何 int. 呵唷，哎呀，嗨 n. 原因 
wicked	[ˈwɪkɪd] adj. 邪恶的 
wide	[waɪd] adj. 宽的 adv. 广泛地 n. 广大的世界 
width	[wɪdθ, wɪdθ, wɪθ, wɪtθ] n. 宽度 
wife	[waɪf] n. 妻子，太太 
wild	[waɪld] adj. 野生的 n. 荒野 adv. 疯狂地 
will	[wɪl] n. 愿意 vt. 决心要 vi. 愿意， 希望， 想要 aux. 将，将会 
willing	[ˈwɪlɪŋ] adj. 乐意的，愿意的;自愿的，心甘情愿的 v. will的现在分词;决心 
win	[wɪn] vt.&vi. （在…中）获胜，赢 vt. （通过努力等）赢得 n. （体育比赛中）胜利，赢 vi. 顺利到达，成功 
wind	[wɪnd] n. 风 vt. 蜿蜒 adj. 管乐的 
window	[ˈwɪndoʊ, ˈwɪndəʊ] n. 窗口 
wine	[waɪn] n. 葡萄酒 vt. 请…喝酒 vi. 喝酒 
wing	[wɪŋ] n. 翅膀，翼 vi. 飞行 vt. 为…装上翼 
winter	[ˈwɪntə(r), ˈwɪntɚ] n. 冬，冬天 v. 过冬 adj. 冬天的，冬季的 
wipe	[waɪp] vt. 擦，拭 n. 擦，拭 vi. 擦，抹 
wire	[ˈwaɪə(r), waɪr] n. 电线 vi. 拍电报 vt. 拍电报 
wireless	[ˈwaɪələs, ˈwaɪərləs] adj. 不用电线的，用无线电波传送的 n. 无线电，无线电话系统;无线电接收机或发射机 
wisdom	[ˈwɪzdəm] n. 智慧，明智 
wise	[waɪz] adj. 聪明的，有智慧的 vt. 使知道，使懂得 vi. 了解，知道 
wish	[wɪʃ] v. 希望;祝愿 n. 希望;愿望 
wit	[wɪt] n. 机智 
with	[wɪð, wɪθ] prep. 随着 
withdraw	[wɪðˈdrɔ:, wɪðˈdrɔ, wɪθ-] vt. 撤退;撤走 vi. 撤退;（从活动或组织中） 退出 
withhold	[wɪðˈhoʊld, wɪðˈhəʊld] vt. 扣留;拒绝给予 vi. 忍住，克制 
within	[wɪðˈɪn, wɪθ-, wɪˈðɪn] adv. 在内，在里面 prep. 不超过，在…的范围内 n. 内部，里面 
without	[wɪˈðaʊt, wɪðˈaʊt, wɪθ-] adv. 在外部 prep. 没有，缺乏 conj. 除非，如果不 
withstand	[wɪðˈstænd, wɪθˈstænd, wɪð-] vt. 经受，承受，禁得起;反抗 vi. 反抗;耐得住，禁得起 
witness	[ˈwɪtnɪs, ˈwɪtnəs] n. 目击者，见证人 vt. 出席或知道 vi. 见证 
wolf	[wʊlf] n. 狼;贪婪的人 vt. 狼吞虎咽 
woman	[ˈwʊmən] n. 女人，妇女 
wonder	[ˈwʌndə(r), ˈwʌndɚ] adj. 奇妙的 n. 奇迹 vt. 惊奇 vi. 惊讶 
wonderful	[ˈwʌndəfl, ˈwʌndərfl] adj. 美妙 
wood	[wʊd] n. 木材 vi. 收集木材 vt. 在…植树造林 adj. 木制的 
wooden	[ˈwʊdn] adj. 木制的 
wool	[wʊl] n. 羊毛 
woollen	['wʊlən, ˈwʊlən] adj. 羊毛制的;毛织的 n. 毛织品;呢绒 
word	[wɜ:d, wɜ:rd] n. 单词 vt. 措辞，用词 vi. 讲话 
work	[wɜ:k, wɜ:rk] vt.&vi. 使工作 n. 工作，操作 vt. 使工作 
worker	[ˈwɜ:kə(r), ˈwɜ:rkə(r)] n. 劳动者 
workshop	[ˈwɜ:rkʃɑ:p, ˈwɜ:kʃɒp] n. 车间 
world	[wɜ:ld, wɜ:rld] n. 世界 
worm	[wɜ:rm, wɜ:m] n. 虫，蠕虫;（昆虫的）幼虫 vt.&vi. 蠕动，曲折行进;给（动物）驱肠虫 
worry	[ˈwʌri, ˈwɜ:ri] n. 担心 vi. 担心，焦虑 vt. 使烦恼 
worse	[wɜ:s, wɜ:rs] adj. 更坏的 adv. 更坏地，更糟地 n. 更坏的事物 
worth	[wɜ:θ, wɜ:rθ] adj. 值得的;有…的价值 n. 价值;财富，财产 
worthy	[ˈwɜ:ði, ˈwɜ:rði] adj. 应得某事物;值得做某事 n. 杰出人物，伟人 
would	[wʊd] aux. 愿意;将，将要 v. (will 的过去式，用于转述)将 
wrap	[ræp] vt. 包 n. 膝毯，披肩，围巾，围脖，头巾，罩衫，外套，大衣 vi. 缠绕，盘绕（通常与 over
wreck	[rek, rɛk] vt. 破坏，毁坏 n. 毁灭，失事 vi. 使（船舶）失事，使遇难，使下沉 
wrist	[rɪst] n. 腕关节 
write	[raɪt] vt.&vi. 写 
writer	[ˈraɪtə(r), ˈraɪtɚ] n. 作家 
writing	[ˈraɪtɪŋ] n. 写作;文字 v. 写信;写（ write的现在分词） 
yard	[jɑ:d, jɑ:rd] n. 院子 
year	[jɪə(r), jɪr] n. 年 
yearly	[ˈjɪəli, ˈjɪrli] adj. 每年的，一年一度的 adv. 每年，一年一度 n. 年利 
yellow	[ˈjeləʊ, ˈjeloʊ] adj. 黄色的 vt.&vi. （使某物）变黄或发黄 n. 黄色 
yes	[jes, jɛs] adv. 是;（表示刚想起某事）哦 n. “是”，“行”;同意，答应 
yesterday	[ˈjestərdeɪ, ˈjestədeɪ] n. 昨天;往昔 adv. 在昨天，在昨日;近来 
yet	[jet, jɛt] adv. 还;但是 conj. 然而，但是 
yield	[ji:ld, jild] vt. 屈服，投降 vi. 放弃，屈服 n. 产量，产额 
you	[ju, jə] pron. 你 
young	[jʌŋ] adj. 年幼的;青年的 n. 年轻人;幼小的动物，崽 
your	[jɔ:(r), jʊr] pron. 你的，你们的 
yours	[jɔ:z, jərz] pron. 你（们）的东西;你的责任[义务] adj. 你（们）的（东西）;信末署名前用语 
yourself	[jərˈself, jɔ:ˈself] pron. 你自己 
youth	[ju:θ, juθ] n. 年轻 
zeal	[zi:l, zil] n. 热情 
zero	[ˈzɪərəʊ, ˈzɪroʊ] n. 零度 adj. 全无的，没有的 v.. 聚焦，集中 
zone	[zoʊn, zəʊn] n. 地带 vt. 划分成带 vi. 分成区，分成地带 
zoo	[zu:, zu] n. 动物园 
